granularity_geo,location_name,date,new_dose_1,new_dose_2,total_dose_1,total_dose_2,total_pr100_dose_1,total_pr100_dose_2,new_doses,total_doses,source
county,Oslo,2020-12-27,5,0,5,0,0.00072098677133472,0.0,5,5,fhi:git
county,Oslo,2020-12-28,264,0,269,0,0.0387890882978079,0.0,264,269,fhi:git
county,Oslo,2020-12-29,118,0,387,0,0.0558043761013073,0.0,118,387,fhi:git
county,Oslo,2020-12-30,58,0,445,0,0.06416782264879001,0.0,58,445,fhi:git
county,Oslo,2020-12-31,5,0,450,0,0.0648888094201248,0.0,5,450,fhi:git
county,Oslo,2021-01-01,6,0,456,0,0.0657539935457264,0.0,6,456,fhi:git
county,Oslo,2021-01-02,0,0,456,0,0.0657539935457264,0.0,0,456,fhi:git
county,Oslo,2021-01-03,0,0,456,0,0.0657539935457264,0.0,0,456,fhi:git
county,Oslo,2021-01-04,0,0,456,0,0.0657539935457264,0.0,0,456,fhi:git
county,Oslo,2021-01-05,480,0,936,0,0.13496872359386,0.0,480,936,fhi:git
county,Oslo,2021-01-06,605,0,1541,0,0.22220812292536102,0.0,605,1541,fhi:git
county,Oslo,2021-01-07,964,0,2505,0,0.361214372438695,0.0,964,2505,fhi:git
county,Oslo,2021-01-08,449,0,2954,0,0.42595898450455205,0.0,449,2954,fhi:git
county,Oslo,2021-01-09,126,0,3080,0,0.44412785114218706,0.0,126,3080,fhi:git
county,Oslo,2021-01-10,100,0,3180,0,0.458547586568882,0.0,100,3180,fhi:git
county,Oslo,2021-01-11,76,0,3256,0,0.469506585493169,0.0,76,3256,fhi:git
county,Oslo,2021-01-12,238,0,3494,0,0.503825555808702,0.0,238,3494,fhi:git
county,Oslo,2021-01-13,488,0,3982,0,0.5741938646909711,0.0,488,3982,fhi:git
county,Oslo,2021-01-14,1231,0,5213,0,0.7517008077935791,0.0,1231,5213,fhi:git
county,Oslo,2021-01-15,1654,0,6867,0,0.990203231751104,0.0,1654,6867,fhi:git
county,Oslo,2021-01-16,632,0,7499,0,1.08133595964781,0.0,632,7499,fhi:git
county,Oslo,2021-01-17,277,5,7776,5,1.1212786267797599,0.00072098677133472,282,7781,fhi:git
county,Oslo,2021-01-18,739,231,8515,236,1.22784047158303,0.0340305756069988,970,8751,fhi:git
county,Oslo,2021-01-19,807,69,9322,305,1.34420773647645,0.0439801930514179,876,9627,fhi:git
county,Oslo,2021-01-20,947,99,10269,404,1.48076263096725,0.0582557311238453,1046,10673,fhi:git
county,Oslo,2021-01-21,971,21,11240,425,1.6207782619604498,0.0612838755634512,992,11665,fhi:git
county,Oslo,2021-01-22,661,6,11901,431,1.7160927131309,0.0621490596890528,667,12332,fhi:git
county,Oslo,2021-01-23,231,0,12132,431,1.74940230196656,0.0621490596890528,231,12563,fhi:git
county,Oslo,2021-01-24,65,0,12197,431,1.75877512999392,0.0621490596890528,65,12628,fhi:git
county,Oslo,2021-01-25,257,0,12454,431,1.7958338500405202,0.0621490596890528,257,12885,fhi:git
county,Oslo,2021-01-26,279,402,12733,833,1.8360649118810002,0.120116396104364,681,13566,fhi:git
county,Oslo,2021-01-27,960,524,13693,1357,1.97449437197726,0.19567580974024298,1484,15050,fhi:git
county,Oslo,2021-01-28,805,839,14498,2196,2.09057324216215,0.316657389970209,1644,16694,fhi:git
county,Oslo,2021-01-29,362,495,14860,2691,2.1427726844067903,0.388035080332346,857,17551,fhi:git
county,Oslo,2021-01-30,78,147,14938,2838,2.15402007803961,0.40923209140958705,225,17776,fhi:git
county,Oslo,2021-01-31,60,44,14998,2882,2.16267191929562,0.41557677499733203,104,17880,fhi:git
county,Oslo,2021-02-01,51,46,15049,2928,2.17002598436324,0.4222098532936121,97,17977,fhi:git
county,Rogaland,2020-12-27,0,0,0,0,0.0,0.0,0,0,fhi:git
county,Rogaland,2020-12-28,0,0,0,0,0.0,0.0,0,0,fhi:git
county,Rogaland,2020-12-29,0,0,0,0,0.0,0.0,0,0,fhi:git
county,Rogaland,2020-12-30,0,0,0,0,0.0,0.0,0,0,fhi:git
county,Rogaland,2020-12-31,0,0,0,0,0.0,0.0,0,0,fhi:git
county,Rogaland,2021-01-01,0,0,0,0,0.0,0.0,0,0,fhi:git
county,Rogaland,2021-01-02,0,0,0,0,0.0,0.0,0,0,fhi:git
county,Rogaland,2021-01-03,0,0,0,0,0.0,0.0,0,0,fhi:git
county,Rogaland,2021-01-04,0,0,0,0,0.0,0.0,0,0,fhi:git
county,Rogaland,2021-01-05,548,0,548,0,0.11419235994765499,0.0,548,548,fhi:git
county,Rogaland,2021-01-06,641,0,1189,0,0.24776408025139,0.0,641,1189,fhi:git
county,Rogaland,2021-01-07,210,0,1399,0,0.291523926216732,0.0,210,1399,fhi:git
county,Rogaland,2021-01-08,21,0,1420,0,0.295899910813266,0.0,21,1420,fhi:git
county,Rogaland,2021-01-09,0,0,1420,0,0.295899910813266,0.0,0,1420,fhi:git
county,Rogaland,2021-01-10,0,0,1420,0,0.295899910813266,0.0,0,1420,fhi:git
county,Rogaland,2021-01-11,1,0,1421,0,0.296108291032149,0.0,1,1421,fhi:git
county,Rogaland,2021-01-12,129,0,1550,0,0.32298933926800205,0.0,129,1550,fhi:git
county,Rogaland,2021-01-13,760,0,2310,0,0.481358305618764,0.0,760,2310,fhi:git
county,Rogaland,2021-01-14,523,0,2833,0,0.590341160094355,0.0,523,2833,fhi:git
county,Rogaland,2021-01-15,287,0,3120,0,0.6501462829136561,0.0,287,3120,fhi:git
county,Rogaland,2021-01-16,0,0,3120,0,0.6501462829136561,0.0,0,3120,fhi:git
county,Rogaland,2021-01-17,0,0,3120,0,0.6501462829136561,0.0,0,3120,fhi:git
county,Rogaland,2021-01-18,71,0,3191,0,0.6649412784543189,0.0,71,3191,fhi:git
county,Rogaland,2021-01-19,511,0,3702,0,0.7714235703033181,0.0,511,3702,fhi:git
county,Rogaland,2021-01-20,616,0,4318,0,0.899785785134989,0.0,616,4318,fhi:git
county,Rogaland,2021-01-21,423,0,4741,0,0.9879306177223208,0.0,423,4741,fhi:git
county,Rogaland,2021-01-22,266,0,5007,0,1.04335975594509,0.0,266,5007,fhi:git
county,Rogaland,2021-01-23,0,0,5007,0,1.04335975594509,0.0,0,5007,fhi:git
county,Rogaland,2021-01-24,0,0,5007,0,1.04335975594509,0.0,0,5007,fhi:git
county,Rogaland,2021-01-25,148,0,5155,0,1.07420002833971,0.0,148,5155,fhi:git
county,Rogaland,2021-01-26,335,381,5490,381,1.14400740166537,0.0793928633942637,716,5871,fhi:git
county,Rogaland,2021-01-27,818,599,6308,980,1.31446242071133,0.20421261450493,1417,7288,fhi:git
county,Rogaland,2021-01-28,493,279,6801,1259,1.4171938686204402,0.262350695573171,772,8060,fhi:git
county,Rogaland,2021-01-29,391,16,7192,1275,1.49867053420353,0.265684779075292,407,8467,fhi:git
county,Rogaland,2021-01-30,2,0,7194,1275,1.49908729464129,0.265684779075292,2,8469,fhi:git
county,Rogaland,2021-01-31,0,0,7194,1275,1.49908729464129,0.265684779075292,0,8469,fhi:git
county,Rogaland,2021-02-01,12,5,7206,1280,1.50158785726789,0.266726680169705,17,8486,fhi:git
county,Møre og Romsdal,2020-12-27,0,0,0,0,0.0,0.0,0,0,fhi:git
county,Møre og Romsdal,2020-12-28,0,0,0,0,0.0,0.0,0,0,fhi:git
county,Møre og Romsdal,2020-12-29,0,0,0,0,0.0,0.0,0,0,fhi:git
county,Møre og Romsdal,2020-12-30,0,0,0,0,0.0,0.0,0,0,fhi:git
county,Møre og Romsdal,2020-12-31,0,0,0,0,0.0,0.0,0,0,fhi:git
county,Møre og Romsdal,2021-01-01,0,0,0,0,0.0,0.0,0,0,fhi:git
county,Møre og Romsdal,2021-01-02,0,0,0,0,0.0,0.0,0,0,fhi:git
county,Møre og Romsdal,2021-01-03,0,0,0,0,0.0,0.0,0,0,fhi:git
county,Møre og Romsdal,2021-01-04,0,0,0,0,0.0,0.0,0,0,fhi:git
county,Møre og Romsdal,2021-01-05,186,0,186,0,0.0701256984293352,0.0,186,186,fhi:git
county,Møre og Romsdal,2021-01-06,497,0,683,0,0.257504580791591,0.0,497,683,fhi:git
county,Møre og Romsdal,2021-01-07,457,0,1140,0,0.429802667792699,0.0,457,1140,fhi:git
county,Møre og Romsdal,2021-01-08,35,0,1175,0,0.442998363733703,0.0,35,1175,fhi:git
county,Møre og Romsdal,2021-01-09,0,0,1175,0,0.442998363733703,0.0,0,1175,fhi:git
county,Møre og Romsdal,2021-01-10,0,0,1175,0,0.442998363733703,0.0,0,1175,fhi:git
county,Møre og Romsdal,2021-01-11,0,0,1175,0,0.442998363733703,0.0,0,1175,fhi:git
county,Møre og Romsdal,2021-01-12,227,0,1402,0,0.528581877408215,0.0,227,1402,fhi:git
county,Møre og Romsdal,2021-01-13,386,0,1788,0,0.674111552643286,0.0,386,1788,fhi:git
county,Møre og Romsdal,2021-01-14,404,0,2192,0,0.8264275857908749,0.0,404,2192,fhi:git
county,Møre og Romsdal,2021-01-15,152,0,2344,0,0.883734608163235,0.0,152,2344,fhi:git
county,Møre og Romsdal,2021-01-16,1,0,2345,0,0.8841116280472628,0.0,1,2345,fhi:git
county,Møre og Romsdal,2021-01-17,1,0,2346,0,0.884488647931292,0.0,1,2346,fhi:git
county,Møre og Romsdal,2021-01-18,11,0,2357,0,0.8886358666556071,0.0,11,2357,fhi:git
county,Møre og Romsdal,2021-01-19,163,0,2520,0,0.9500901077522829,0.0,163,2520,fhi:git
county,Møre og Romsdal,2021-01-20,487,0,3007,0,1.13369879127425,0.0,487,3007,fhi:git
county,Møre og Romsdal,2021-01-21,756,0,3763,0,1.41872582359994,0.0,756,3763,fhi:git
county,Møre og Romsdal,2021-01-22,210,0,3973,0,1.4978999992459598,0.0,210,3973,fhi:git
county,Møre og Romsdal,2021-01-23,0,0,3973,0,1.4978999992459598,0.0,0,3973,fhi:git
county,Møre og Romsdal,2021-01-24,0,0,3973,0,1.4978999992459598,0.0,0,3973,fhi:git
county,Møre og Romsdal,2021-01-25,3,0,3976,0,1.4990310588980502,0.0,3,3976,fhi:git
county,Møre og Romsdal,2021-01-26,73,127,4049,127,1.52655351043214,0.0478815252716428,200,4176,fhi:git
county,Møre og Romsdal,2021-01-27,515,336,4564,463,1.72071875070691,0.174560206305281,851,5027,fhi:git
county,Møre og Romsdal,2021-01-28,461,446,5025,909,1.8945249172441398,0.342711074582073,907,5934,fhi:git
county,Møre og Romsdal,2021-01-29,78,66,5103,975,1.92393246819837,0.3675943869279671,144,6078,fhi:git
county,Møre og Romsdal,2021-01-30,0,0,5103,975,1.92393246819837,0.3675943869279671,0,6078,fhi:git
county,Møre og Romsdal,2021-01-31,0,0,5103,975,1.92393246819837,0.3675943869279671,0,6078,fhi:git
county,Møre og Romsdal,2021-02-01,0,0,5103,975,1.92393246819837,0.3675943869279671,0,6078,fhi:git
county,Nordland,2020-12-27,0,0,0,0,0.0,0.0,0,0,fhi:git
county,Nordland,2020-12-28,0,0,0,0,0.0,0.0,0,0,fhi:git
county,Nordland,2020-12-29,0,0,0,0,0.0,0.0,0,0,fhi:git
county,Nordland,2020-12-30,0,0,0,0,0.0,0.0,0,0,fhi:git
county,Nordland,2020-12-31,0,0,0,0,0.0,0.0,0,0,fhi:git
county,Nordland,2021-01-01,0,0,0,0,0.0,0.0,0,0,fhi:git
county,Nordland,2021-01-02,0,0,0,0,0.0,0.0,0,0,fhi:git
county,Nordland,2021-01-03,0,0,0,0,0.0,0.0,0,0,fhi:git
county,Nordland,2021-01-04,0,0,0,0,0.0,0.0,0,0,fhi:git
county,Nordland,2021-01-05,200,0,200,0,0.0829067092254441,0.0,200,200,fhi:git
county,Nordland,2021-01-06,687,0,887,0,0.367691255414845,0.0,687,887,fhi:git
county,Nordland,2021-01-07,238,0,1125,0,0.46635023939312303,0.0,238,1125,fhi:git
county,Nordland,2021-01-08,115,0,1240,0,0.514021597197753,0.0,115,1240,fhi:git
county,Nordland,2021-01-09,0,0,1240,0,0.514021597197753,0.0,0,1240,fhi:git
county,Nordland,2021-01-10,0,0,1240,0,0.514021597197753,0.0,0,1240,fhi:git
county,Nordland,2021-01-11,0,0,1240,0,0.514021597197753,0.0,0,1240,fhi:git
county,Nordland,2021-01-12,291,0,1531,0,0.6346508591207739,0.0,291,1531,fhi:git
county,Nordland,2021-01-13,602,0,2133,0,0.8842000538893611,0.0,602,2133,fhi:git
county,Nordland,2021-01-14,274,0,2407,0,0.997782245528219,0.0,274,2407,fhi:git
county,Nordland,2021-01-15,69,0,2476,0,1.026385060211,0.0,69,2476,fhi:git
county,Nordland,2021-01-16,0,0,2476,0,1.026385060211,0.0,0,2476,fhi:git
county,Nordland,2021-01-17,0,0,2476,0,1.026385060211,0.0,0,2476,fhi:git
county,Nordland,2021-01-18,0,0,2476,0,1.026385060211,0.0,0,2476,fhi:git
county,Nordland,2021-01-19,314,0,2790,0,1.15654859369494,0.0,314,2790,fhi:git
county,Nordland,2021-01-20,785,0,3575,0,1.4819574274048102,0.0,785,3575,fhi:git
county,Nordland,2021-01-21,613,0,4188,0,1.7360664911808,0.0,613,4188,fhi:git
county,Nordland,2021-01-22,165,0,4353,0,1.80446452629179,0.0,165,4353,fhi:git
county,Nordland,2021-01-23,1,0,4354,0,1.80487905983792,0.0,1,4354,fhi:git
county,Nordland,2021-01-24,0,0,4354,0,1.80487905983792,0.0,0,4354,fhi:git
county,Nordland,2021-01-25,51,0,4405,0,1.8260202706904098,0.0,51,4405,fhi:git
county,Nordland,2021-01-26,95,90,4500,90,1.86540095757249,0.0373080191514498,185,4590,fhi:git
county,Nordland,2021-01-27,607,528,5107,618,2.11702282007171,0.256181731506622,1135,5725,fhi:git
county,Nordland,2021-01-28,467,362,5574,980,2.3106099861131297,0.406242875204676,829,6554,fhi:git
county,Nordland,2021-01-29,205,96,5779,1076,2.39558936306921,0.446038095632889,301,6855,fhi:git
county,Nordland,2021-01-30,0,0,5779,1076,2.39558936306921,0.446038095632889,0,6855,fhi:git
county,Nordland,2021-01-31,0,0,5779,1076,2.39558936306921,0.446038095632889,0,6855,fhi:git
county,Nordland,2021-02-01,7,4,5786,1080,2.3984910978921,0.447696229817398,11,6866,fhi:git
county,Viken,2020-12-27,0,0,0,0,0.0,0.0,0,0,fhi:git
county,Viken,2020-12-28,64,0,64,0,0.0051564457586219395,0.0,64,64,fhi:git
county,Viken,2020-12-29,690,0,754,0,0.0607493765937647,0.0,690,754,fhi:git
county,Viken,2020-12-30,215,0,969,0,0.0780718115641353,0.0,215,969,fhi:git
county,Viken,2020-12-31,67,0,1036,0,0.0834699657176927,0.0,67,1036,fhi:git
county,Viken,2021-01-01,0,0,1036,0,0.0834699657176927,0.0,0,1036,fhi:git
county,Viken,2021-01-02,0,0,1036,0,0.0834699657176927,0.0,0,1036,fhi:git
county,Viken,2021-01-03,0,0,1036,0,0.0834699657176927,0.0,0,1036,fhi:git
county,Viken,2021-01-04,0,0,1036,0,0.0834699657176927,0.0,0,1036,fhi:git
county,Viken,2021-01-05,507,0,1543,0,0.124318684461776,0.0,507,1543,fhi:git
county,Viken,2021-01-06,1641,0,3184,0,0.25653317649144197,0.0,1641,3184,fhi:git
county,Viken,2021-01-07,1909,0,5093,0,0.41034028513533705,0.0,1909,5093,fhi:git
county,Viken,2021-01-08,279,0,5372,0,0.43281916586432895,0.0,279,5372,fhi:git
county,Viken,2021-01-09,6,0,5378,0,0.4333025826542001,0.0,6,5378,fhi:git
county,Viken,2021-01-10,4,0,5382,0,0.433624860514114,0.0,4,5382,fhi:git
county,Viken,2021-01-11,55,0,5437,0,0.43805618108792893,0.0,55,5437,fhi:git
county,Viken,2021-01-12,767,0,6204,0,0.499852960726414,0.0,767,6204,fhi:git
county,Viken,2021-01-13,1926,0,8130,0,0.6550297502749429,0.0,1926,8130,fhi:git
county,Viken,2021-01-14,1944,0,10074,0,0.8116567901930849,0.0,1944,10074,fhi:git
county,Viken,2021-01-15,1039,0,11113,0,0.895368464305713,0.0,1039,11113,fhi:git
county,Viken,2021-01-16,85,0,11198,0,0.9022168688288829,0.0,85,11198,fhi:git
county,Viken,2021-01-17,22,0,11220,0,0.903989397058409,0.0,22,11220,fhi:git
county,Viken,2021-01-18,141,51,11361,51,0.9153496916203729,0.00410904271390186,192,11412,fhi:git
county,Viken,2021-01-19,635,380,11996,431,0.9665113018817,0.0347254394057196,1015,12427,fhi:git
county,Viken,2021-01-20,1422,339,13418,770,1.08108108108108,0.0620384880334202,1761,14188,fhi:git
county,Viken,2021-01-21,1917,98,15335,868,1.2355327454448002,0.0699342956013101,2015,16203,fhi:git
county,Viken,2021-01-22,795,1,16130,869,1.29958547010269,0.0700148650662885,796,16999,fhi:git
county,Viken,2021-01-23,97,0,16227,869,1.3074007082056,0.0700148650662885,97,17096,fhi:git
county,Viken,2021-01-24,0,0,16227,869,1.3074007082056,0.0700148650662885,0,17096,fhi:git
county,Viken,2021-01-25,59,0,16286,869,1.3121543066393302,0.0700148650662885,59,17155,fhi:git
county,Viken,2021-01-26,425,389,16711,1258,1.3463963292551802,0.101356386942913,814,17969,fhi:git
county,Viken,2021-01-27,1724,1111,18435,2369,1.4852980868780499,0.19086906253399,2835,20804,fhi:git
county,Viken,2021-01-28,2925,1521,21360,3890,1.72096377194007,0.31341521876624,4446,25250,fhi:git
county,Viken,2021-01-29,901,415,22261,4305,1.79355685988567,0.34685154673230395,1316,26566,fhi:git
county,Viken,2021-01-30,1,17,22262,4322,1.79363742935065,0.348221227636938,18,26584,fhi:git
county,Viken,2021-01-31,0,3,22262,4325,1.79363742935065,0.348462936031873,3,26587,fhi:git
county,Viken,2021-02-01,13,44,22275,4369,1.79468483239537,0.352007992490926,57,26644,fhi:git
county,Innlandet,2020-12-27,0,0,0,0,0.0,0.0,0,0,fhi:git
county,Innlandet,2020-12-28,271,0,271,0,0.07297009841539098,0.0,271,271,fhi:git
county,Innlandet,2020-12-29,260,0,531,0,0.142978310917242,0.0,260,531,fhi:git
county,Innlandet,2020-12-30,149,0,680,0,0.18309840192791801,0.0,149,680,fhi:git
county,Innlandet,2020-12-31,0,0,680,0,0.18309840192791801,0.0,0,680,fhi:git
county,Innlandet,2021-01-01,0,0,680,0,0.18309840192791801,0.0,0,680,fhi:git
county,Innlandet,2021-01-02,0,0,680,0,0.18309840192791801,0.0,0,680,fhi:git
county,Innlandet,2021-01-03,0,0,680,0,0.18309840192791801,0.0,0,680,fhi:git
county,Innlandet,2021-01-04,0,0,680,0,0.18309840192791801,0.0,0,680,fhi:git
county,Innlandet,2021-01-05,321,0,1001,0,0.269531618132127,0.0,321,1001,fhi:git
county,Innlandet,2021-01-06,650,0,1651,0,0.444552149386755,0.0,650,1651,fhi:git
county,Innlandet,2021-01-07,709,0,2360,0,0.635459159632188,0.0,709,2360,fhi:git
county,Innlandet,2021-01-08,76,0,2436,0,0.6559230986711899,0.0,76,2436,fhi:git
county,Innlandet,2021-01-09,0,0,2436,0,0.6559230986711899,0.0,0,2436,fhi:git
county,Innlandet,2021-01-10,0,0,2436,0,0.6559230986711899,0.0,0,2436,fhi:git
county,Innlandet,2021-01-11,51,0,2487,0,0.6696554788157839,0.0,51,2487,fhi:git
county,Innlandet,2021-01-12,440,0,2927,0,0.788130915357379,0.0,440,2927,fhi:git
county,Innlandet,2021-01-13,951,0,3878,0,1.04419941570069,0.0,951,3878,fhi:git
county,Innlandet,2021-01-14,939,0,4817,0,1.29703676777468,0.0,939,4817,fhi:git
county,Innlandet,2021-01-15,271,0,5088,0,1.3700068661900702,0.0,271,5088,fhi:git
county,Innlandet,2021-01-16,4,0,5092,0,1.3710839156131798,0.0,4,5092,fhi:git
county,Innlandet,2021-01-17,0,0,5092,0,1.3710839156131798,0.0,0,5092,fhi:git
county,Innlandet,2021-01-18,67,0,5159,0,1.3891244934501898,0.0,67,5159,fhi:git
county,Innlandet,2021-01-19,331,318,5490,318,1.47825033321217,0.0856254291368795,649,5808,fhi:git
county,Innlandet,2021-01-20,656,252,6146,570,1.6548864386014501,0.15347954279252,908,6716,fhi:git
county,Innlandet,2021-01-21,826,48,6972,618,1.87729714447272,0.166404135869785,874,7590,fhi:git
county,Innlandet,2021-01-22,220,0,7192,618,1.93653486274351,0.166404135869785,220,7810,fhi:git
county,Innlandet,2021-01-23,5,0,7197,618,1.9378811745223998,0.166404135869785,5,7815,fhi:git
county,Innlandet,2021-01-24,0,0,7197,618,1.9378811745223998,0.166404135869785,0,7815,fhi:git
county,Innlandet,2021-01-25,2,0,7199,618,1.9384196992339502,0.166404135869785,2,7817,fhi:git
county,Innlandet,2021-01-26,141,130,7340,748,1.97638569139841,0.20140824212070998,271,8088,fhi:git
county,Innlandet,2021-01-27,896,534,8236,1282,2.2176447621740203,0.345194340105282,1430,9518,fhi:git
county,Innlandet,2021-01-28,848,697,9084,1979,2.44597923987237,0.5328702020813979,1545,11063,fhi:git
county,Innlandet,2021-01-29,286,132,9370,2111,2.52298827362441,0.568412833043876,418,11481,fhi:git
county,Innlandet,2021-01-30,1,0,9371,2111,2.5232575359801803,0.568412833043876,1,11482,fhi:git
county,Innlandet,2021-01-31,0,0,9371,2111,2.5232575359801803,0.568412833043876,0,11482,fhi:git
county,Innlandet,2021-02-01,8,49,9379,2160,2.52541163482639,0.581606688476918,57,11539,fhi:git
county,Vestfold og Telemark,2020-12-27,0,0,0,0,0.0,0.0,0,0,fhi:git
county,Vestfold og Telemark,2020-12-28,0,0,0,0,0.0,0.0,0,0,fhi:git
county,Vestfold og Telemark,2020-12-29,0,0,0,0,0.0,0.0,0,0,fhi:git
county,Vestfold og Telemark,2020-12-30,0,0,0,0,0.0,0.0,0,0,fhi:git
county,Vestfold og Telemark,2020-12-31,0,0,0,0,0.0,0.0,0,0,fhi:git
county,Vestfold og Telemark,2021-01-01,0,0,0,0,0.0,0.0,0,0,fhi:git
county,Vestfold og Telemark,2021-01-02,0,0,0,0,0.0,0.0,0,0,fhi:git
county,Vestfold og Telemark,2021-01-03,0,0,0,0,0.0,0.0,0,0,fhi:git
county,Vestfold og Telemark,2021-01-04,0,0,0,0,0.0,0.0,0,0,fhi:git
county,Vestfold og Telemark,2021-01-05,218,0,218,0,0.0519795133954544,0.0,218,218,fhi:git
county,Vestfold og Telemark,2021-01-06,1025,0,1243,0,0.296378601608027,0.0,1025,1243,fhi:git
county,Vestfold og Telemark,2021-01-07,442,0,1685,0,0.401768257207985,0.0,442,1685,fhi:git
county,Vestfold og Telemark,2021-01-08,64,0,1749,0,0.41702829783784295,0.0,64,1749,fhi:git
county,Vestfold og Telemark,2021-01-09,0,0,1749,0,0.41702829783784295,0.0,0,1749,fhi:git
county,Vestfold og Telemark,2021-01-10,2,0,1751,0,0.417505174107526,0.0,2,1751,fhi:git
county,Vestfold og Telemark,2021-01-11,2,0,1753,0,0.417982050377209,0.0,2,1753,fhi:git
county,Vestfold og Telemark,2021-01-12,419,0,2172,0,0.517887628875812,0.0,419,2172,fhi:git
county,Vestfold og Telemark,2021-01-13,1154,0,3326,0,0.793045236482942,0.0,1154,3326,fhi:git
county,Vestfold og Telemark,2021-01-14,585,0,3911,0,0.93253154536524,0.0,585,3911,fhi:git
county,Vestfold og Telemark,2021-01-15,157,0,4068,0,0.96996633253536,0.0,157,4068,fhi:git
county,Vestfold og Telemark,2021-01-16,3,0,4071,0,0.970681646939885,0.0,3,4071,fhi:git
county,Vestfold og Telemark,2021-01-17,39,0,4110,0,0.9799807341987049,0.0,39,4110,fhi:git
county,Vestfold og Telemark,2021-01-18,5,0,4115,0,0.981172924872912,0.0,5,4115,fhi:git
county,Vestfold og Telemark,2021-01-19,226,0,4341,0,1.0350599433471,0.0,226,4341,fhi:git
county,Vestfold og Telemark,2021-01-20,1600,0,5941,0,1.4165609590935502,0.0,1600,5941,fhi:git
county,Vestfold og Telemark,2021-01-21,815,0,6756,0,1.6108880389894,0.0,815,6756,fhi:git
county,Vestfold og Telemark,2021-01-22,178,0,6934,0,1.6533300269912,0.0,178,6934,fhi:git
county,Vestfold og Telemark,2021-01-23,3,0,6937,0,1.65404534139572,0.0,3,6937,fhi:git
county,Vestfold og Telemark,2021-01-24,0,0,6937,0,1.65404534139572,0.0,0,6937,fhi:git
county,Vestfold og Telemark,2021-01-25,45,0,6982,0,1.6647750574635902,0.0,45,6982,fhi:git
county,Vestfold og Telemark,2021-01-26,91,160,7073,160,1.68647292773417,0.0381501015746454,251,7233,fhi:git
county,Vestfold og Telemark,2021-01-27,1596,897,8669,1057,2.06702019094126,0.252029108527501,2493,9726,fhi:git
county,Vestfold og Telemark,2021-01-28,630,449,9299,1506,2.2172362158914303,0.35908783107135,1079,10805,fhi:git
county,Vestfold og Telemark,2021-01-29,74,90,9373,1596,2.2348806378697,0.380547263207088,164,10969,fhi:git
county,Vestfold og Telemark,2021-01-30,0,0,9373,1596,2.2348806378697,0.380547263207088,0,10969,fhi:git
county,Vestfold og Telemark,2021-01-31,0,1,9373,1597,2.2348806378697,0.38078570134192996,1,10970,fhi:git
county,Vestfold og Telemark,2021-02-01,0,0,9373,1597,2.2348806378697,0.38078570134192996,0,10970,fhi:git
county,Agder,2020-12-27,0,0,0,0,0.0,0.0,0,0,fhi:git
county,Agder,2020-12-28,0,0,0,0,0.0,0.0,0,0,fhi:git
county,Agder,2020-12-29,0,0,0,0,0.0,0.0,0,0,fhi:git
county,Agder,2020-12-30,0,0,0,0,0.0,0.0,0,0,fhi:git
county,Agder,2020-12-31,0,0,0,0,0.0,0.0,0,0,fhi:git
county,Agder,2021-01-01,0,0,0,0,0.0,0.0,0,0,fhi:git
county,Agder,2021-01-02,0,0,0,0,0.0,0.0,0,0,fhi:git
county,Agder,2021-01-03,0,0,0,0,0.0,0.0,0,0,fhi:git
county,Agder,2021-01-04,0,0,0,0,0.0,0.0,0,0,fhi:git
county,Agder,2021-01-05,79,0,79,0,0.0257135510413988,0.0,79,79,fhi:git
county,Agder,2021-01-06,791,0,870,0,0.283174549443253,0.0,791,870,fhi:git
county,Agder,2021-01-07,230,0,1100,0,0.35803678665238897,0.0,230,1100,fhi:git
county,Agder,2021-01-08,49,0,1149,0,0.37398569805781295,0.0,49,1149,fhi:git
county,Agder,2021-01-09,0,0,1149,0,0.37398569805781295,0.0,0,1149,fhi:git
county,Agder,2021-01-10,0,0,1149,0,0.37398569805781295,0.0,0,1149,fhi:git
county,Agder,2021-01-11,0,0,1149,0,0.37398569805781295,0.0,0,1149,fhi:git
county,Agder,2021-01-12,225,0,1374,0,0.44722049532762,0.0,225,1374,fhi:git
county,Agder,2021-01-13,851,0,2225,0,0.724210773001422,0.0,851,2225,fhi:git
county,Agder,2021-01-14,499,0,2724,0,0.8866292789464609,0.0,499,2724,fhi:git
county,Agder,2021-01-15,118,0,2842,0,0.9250368615146259,0.0,118,2842,fhi:git
county,Agder,2021-01-16,0,0,2842,0,0.9250368615146259,0.0,0,2842,fhi:git
county,Agder,2021-01-17,2,0,2844,0,0.9256878374903579,0.0,2,2844,fhi:git
county,Agder,2021-01-18,15,0,2859,0,0.9305701573083441,0.0,15,2859,fhi:git
county,Agder,2021-01-19,348,0,3207,0,1.04383997708565,0.0,348,3207,fhi:git
county,Agder,2021-01-20,452,0,3659,0,1.19096054760099,0.0,452,3659,fhi:git
county,Agder,2021-01-21,333,0,3992,0,1.2993480475603,0.0,333,3992,fhi:git
county,Agder,2021-01-22,55,0,4047,0,1.3172498868929199,0.0,55,4047,fhi:git
county,Agder,2021-01-23,1,0,4048,0,1.31757537488079,0.0,1,4048,fhi:git
county,Agder,2021-01-24,0,0,4048,0,1.31757537488079,0.0,0,4048,fhi:git
county,Agder,2021-01-25,1,0,4049,0,1.31790086286866,0.0,1,4049,fhi:git
county,Agder,2021-01-26,62,66,4111,66,1.3380811181163401,0.0214822071991433,128,4177,fhi:git
county,Agder,2021-01-27,535,674,4646,740,1.5122171916245402,0.240861111020698,1209,5386,fhi:git
county,Agder,2021-01-28,901,248,5547,988,1.8054818686916398,0.32158213201141805,1149,6535,fhi:git
county,Agder,2021-01-29,184,61,5731,1049,1.8653716584589402,0.34143689927123194,245,6780,fhi:git
county,Agder,2021-01-30,29,0,5760,1049,1.87481081010705,0.34143689927123194,29,6809,fhi:git
county,Agder,2021-01-31,20,0,5780,1049,1.8813205698643702,0.34143689927123194,20,6829,fhi:git
county,Agder,2021-02-01,0,1,5780,1050,1.8813205698643702,0.34176238725909797,1,6830,fhi:git
county,Vestland,2020-12-27,0,0,0,0,0.0,0.0,0,0,fhi:git
county,Vestland,2020-12-28,0,0,0,0,0.0,0.0,0,0,fhi:git
county,Vestland,2020-12-29,0,0,0,0,0.0,0.0,0,0,fhi:git
county,Vestland,2020-12-30,0,0,0,0,0.0,0.0,0,0,fhi:git
county,Vestland,2020-12-31,0,0,0,0,0.0,0.0,0,0,fhi:git
county,Vestland,2021-01-01,0,0,0,0,0.0,0.0,0,0,fhi:git
county,Vestland,2021-01-02,0,0,0,0,0.0,0.0,0,0,fhi:git
county,Vestland,2021-01-03,0,0,0,0,0.0,0.0,0,0,fhi:git
county,Vestland,2021-01-04,1,0,1,0,0.00015710153943798502,0.0,1,1,fhi:git
county,Vestland,2021-01-05,416,0,417,0,0.0655113419456397,0.0,416,417,fhi:git
county,Vestland,2021-01-06,1248,0,1665,0,0.261574063164245,0.0,1248,1665,fhi:git
county,Vestland,2021-01-07,715,0,2380,0,0.373901663862404,0.0,715,2380,fhi:git
county,Vestland,2021-01-08,139,0,2519,0,0.395738777844284,0.0,139,2519,fhi:git
county,Vestland,2021-01-09,0,0,2519,0,0.395738777844284,0.0,0,2519,fhi:git
county,Vestland,2021-01-10,0,0,2519,0,0.395738777844284,0.0,0,2519,fhi:git
county,Vestland,2021-01-11,59,0,2578,0,0.40500776867112503,0.0,59,2578,fhi:git
county,Vestland,2021-01-12,853,0,3431,0,0.539015381811726,0.0,853,3431,fhi:git
county,Vestland,2021-01-13,1122,0,4553,0,0.7152833090611459,0.0,1122,4553,fhi:git
county,Vestland,2021-01-14,966,0,5519,0,0.867043396158239,0.0,966,5519,fhi:git
county,Vestland,2021-01-15,421,0,5940,0,0.933183144261631,0.0,421,5940,fhi:git
county,Vestland,2021-01-16,2,0,5942,0,0.933497347340506,0.0,2,5942,fhi:git
county,Vestland,2021-01-17,1,0,5943,0,0.933654448879945,0.0,1,5943,fhi:git
county,Vestland,2021-01-18,54,0,5997,0,0.942137932009596,0.0,54,5997,fhi:git
county,Vestland,2021-01-19,365,0,6362,0,0.99947999390446,0.0,365,6362,fhi:git
county,Vestland,2021-01-20,1234,0,7596,0,1.1933432935709298,0.0,1234,7596,fhi:git
county,Vestland,2021-01-21,767,0,8363,0,1.3138401743198702,0.0,767,8363,fhi:git
county,Vestland,2021-01-22,303,0,8666,0,1.36144194076958,0.0,303,8666,fhi:git
county,Vestland,2021-01-23,0,0,8666,0,1.36144194076958,0.0,0,8666,fhi:git
county,Vestland,2021-01-24,0,0,8666,0,1.36144194076958,0.0,0,8666,fhi:git
county,Vestland,2021-01-25,1,0,8667,0,1.36159904230902,0.0,1,8667,fhi:git
county,Vestland,2021-01-26,149,103,8816,103,1.3850071716852799,0.0161814585621125,252,8919,fhi:git
county,Vestland,2021-01-27,1514,1166,10330,1269,1.62285890239438,0.199361853546803,2680,11599,fhi:git
county,Vestland,2021-01-28,1871,625,12201,1894,1.9167958826828502,0.297550315695544,2496,14095,fhi:git
county,Vestland,2021-01-29,461,140,12662,2034,1.98921969236377,0.319544531216861,601,14696,fhi:git
county,Vestland,2021-01-30,0,0,12662,2034,1.98921969236377,0.319544531216861,0,14696,fhi:git
county,Vestland,2021-01-31,0,0,12662,2034,1.98921969236377,0.319544531216861,0,14696,fhi:git
county,Vestland,2021-02-01,14,56,12676,2090,1.9914191139159,0.328342217425389,70,14766,fhi:git
county,Trøndelag,2020-12-27,0,0,0,0,0.0,0.0,0,0,fhi:git
county,Trøndelag,2020-12-28,0,0,0,0,0.0,0.0,0,0,fhi:git
county,Trøndelag,2020-12-29,0,0,0,0,0.0,0.0,0,0,fhi:git
county,Trøndelag,2020-12-30,0,0,0,0,0.0,0.0,0,0,fhi:git
county,Trøndelag,2020-12-31,0,0,0,0,0.0,0.0,0,0,fhi:git
county,Trøndelag,2021-01-01,0,0,0,0,0.0,0.0,0,0,fhi:git
county,Trøndelag,2021-01-02,0,0,0,0,0.0,0.0,0,0,fhi:git
county,Trøndelag,2021-01-03,0,0,0,0,0.0,0.0,0,0,fhi:git
county,Trøndelag,2021-01-04,0,0,0,0,0.0,0.0,0,0,fhi:git
county,Trøndelag,2021-01-05,411,0,411,0,0.0876889793514856,0.0,411,411,fhi:git
county,Trøndelag,2021-01-06,674,0,1085,0,0.231490371280686,0.0,674,1085,fhi:git
county,Trøndelag,2021-01-07,482,0,1567,0,0.334327568476345,0.0,482,1567,fhi:git
county,Trøndelag,2021-01-08,140,0,1707,0,0.364197293802885,0.0,140,1707,fhi:git
county,Trøndelag,2021-01-09,0,0,1707,0,0.364197293802885,0.0,0,1707,fhi:git
county,Trøndelag,2021-01-10,0,0,1707,0,0.364197293802885,0.0,0,1707,fhi:git
county,Trøndelag,2021-01-11,95,0,1802,0,0.384466035988752,0.0,95,1802,fhi:git
county,Trøndelag,2021-01-12,498,0,2300,0,0.49071691607887297,0.0,498,2300,fhi:git
county,Trøndelag,2021-01-13,863,0,3163,0,0.6748424371989019,0.0,863,3163,fhi:git
county,Trøndelag,2021-01-14,666,0,3829,0,0.8169369876808721,0.0,666,3829,fhi:git
county,Trøndelag,2021-01-15,253,0,4082,0,0.8709158484495481,0.0,253,4082,fhi:git
county,Trøndelag,2021-01-16,0,0,4082,0,0.8709158484495481,0.0,0,4082,fhi:git
county,Trøndelag,2021-01-17,0,0,4082,0,0.8709158484495481,0.0,0,4082,fhi:git
county,Trøndelag,2021-01-18,155,0,4237,0,0.903985901489646,0.0,155,4237,fhi:git
county,Trøndelag,2021-01-19,568,0,4805,0,1.02517164424304,0.0,568,4805,fhi:git
county,Trøndelag,2021-01-20,734,0,5539,0,1.18177434702647,0.0,734,5539,fhi:git
county,Trøndelag,2021-01-21,495,0,6034,0,1.2873851615738798,0.0,495,6034,fhi:git
county,Trøndelag,2021-01-22,284,0,6318,0,1.34797803295057,0.0,284,6318,fhi:git
county,Trøndelag,2021-01-23,1,0,6319,0,1.34819138813148,0.0,1,6319,fhi:git
county,Trøndelag,2021-01-24,0,0,6319,0,1.34819138813148,0.0,0,6319,fhi:git
county,Trøndelag,2021-01-25,1,0,6320,0,1.34840474331238,0.0,1,6320,fhi:git
county,Trøndelag,2021-01-26,313,184,6633,184,1.41518491493529,0.0392573532863098,497,6817,fhi:git
county,Trøndelag,2021-01-27,962,592,7595,776,1.6204325989647999,0.16556362038139402,1554,8371,fhi:git
county,Trøndelag,2021-01-28,694,453,8289,1229,1.76850109451208,0.26221351733084103,1147,9518,fhi:git
county,Trøndelag,2021-01-29,381,197,8670,1426,1.84978941843645,0.30424448796890097,578,10096,fhi:git
county,Trøndelag,2021-01-30,0,0,8670,1426,1.84978941843645,0.30424448796890097,0,10096,fhi:git
county,Trøndelag,2021-01-31,0,1,8670,1427,1.84978941843645,0.304457843149805,1,10097,fhi:git
county,Trøndelag,2021-02-01,3,86,8673,1513,1.85042948397916,0.322806388707537,89,10186,fhi:git
county,Troms og Finnmark,2020-12-27,0,0,0,0,0.0,0.0,0,0,fhi:git
county,Troms og Finnmark,2020-12-28,1,0,1,0,0.00041099662571770297,0.0,1,1,fhi:git
county,Troms og Finnmark,2020-12-29,0,0,1,0,0.00041099662571770297,0.0,0,1,fhi:git
county,Troms og Finnmark,2020-12-30,0,0,1,0,0.00041099662571770297,0.0,0,1,fhi:git
county,Troms og Finnmark,2020-12-31,0,0,1,0,0.00041099662571770297,0.0,0,1,fhi:git
county,Troms og Finnmark,2021-01-01,0,0,1,0,0.00041099662571770297,0.0,0,1,fhi:git
county,Troms og Finnmark,2021-01-02,0,0,1,0,0.00041099662571770297,0.0,0,1,fhi:git
county,Troms og Finnmark,2021-01-03,0,0,1,0,0.00041099662571770297,0.0,0,1,fhi:git
county,Troms og Finnmark,2021-01-04,0,0,1,0,0.00041099662571770297,0.0,0,1,fhi:git
county,Troms og Finnmark,2021-01-05,53,0,54,0,0.022193817788756,0.0,53,54,fhi:git
county,Troms og Finnmark,2021-01-06,529,0,583,0,0.23961103279342102,0.0,529,583,fhi:git
county,Troms og Finnmark,2021-01-07,188,0,771,0,0.31687839842834903,0.0,188,771,fhi:git
county,Troms og Finnmark,2021-01-08,247,0,1018,0,0.418394564980622,0.0,247,1018,fhi:git
county,Troms og Finnmark,2021-01-09,0,0,1018,0,0.418394564980622,0.0,0,1018,fhi:git
county,Troms og Finnmark,2021-01-10,0,0,1018,0,0.418394564980622,0.0,0,1018,fhi:git
county,Troms og Finnmark,2021-01-11,1,0,1019,0,0.41880556160633897,0.0,1,1019,fhi:git
county,Troms og Finnmark,2021-01-12,189,0,1208,0,0.496483923866985,0.0,189,1208,fhi:git
county,Troms og Finnmark,2021-01-13,575,0,1783,0,0.732806983654664,0.0,575,1783,fhi:git
county,Troms og Finnmark,2021-01-14,329,0,2112,0,0.868024873515788,0.0,329,2112,fhi:git
county,Troms og Finnmark,2021-01-15,37,0,2149,0,0.8832317486673441,0.0,37,2149,fhi:git
county,Troms og Finnmark,2021-01-16,2,0,2151,0,0.8840537419187791,0.0,2,2151,fhi:git
county,Troms og Finnmark,2021-01-17,1,0,2152,0,0.884464738544497,0.0,1,2152,fhi:git
county,Troms og Finnmark,2021-01-18,0,1,2152,1,0.884464738544497,0.00041099662571770297,1,2153,fhi:git
county,Troms og Finnmark,2021-01-19,248,0,2400,1,0.986391901722487,0.00041099662571770297,248,2401,fhi:git
county,Troms og Finnmark,2021-01-20,907,0,3307,1,1.3591658412484398,0.00041099662571770297,907,3308,fhi:git
county,Troms og Finnmark,2021-01-21,247,0,3554,1,1.46068200780072,0.00041099662571770297,247,3555,fhi:git
county,Troms og Finnmark,2021-01-22,81,0,3635,1,1.49397273448385,0.00041099662571770297,81,3636,fhi:git
county,Troms og Finnmark,2021-01-23,12,0,3647,1,1.4989046939924602,0.00041099662571770297,12,3648,fhi:git
county,Troms og Finnmark,2021-01-24,0,0,3647,1,1.4989046939924602,0.00041099662571770297,0,3648,fhi:git
county,Troms og Finnmark,2021-01-25,6,0,3653,1,1.50137067374677,0.00041099662571770297,6,3654,fhi:git
county,Troms og Finnmark,2021-01-26,71,0,3724,1,1.5305514341727298,0.00041099662571770297,71,3725,fhi:git
county,Troms og Finnmark,2021-01-27,663,359,4387,360,1.8030421970235602,0.14795878525837303,1022,4747,fhi:git
county,Troms og Finnmark,2021-01-28,222,260,4609,620,1.8942834479328898,0.254817907944976,482,5229,fhi:git
county,Troms og Finnmark,2021-01-29,102,243,4711,863,1.9362051037561003,0.354690087994378,345,5574,fhi:git
county,Troms og Finnmark,2021-01-30,0,0,4711,863,1.9362051037561003,0.354690087994378,0,5574,fhi:git
county,Troms og Finnmark,2021-01-31,0,0,4711,863,1.9362051037561003,0.354690087994378,0,5574,fhi:git
county,Troms og Finnmark,2021-02-01,1,2,4712,865,1.9366161003818203,0.355512081245813,3,5577,fhi:git
nation,Norge,2020-12-27,5,0,5,0,9.31518486915891e-05,0.0,5,5,fhi:git
nation,Norge,2020-12-28,600,0,605,0,0.0112713736916823,0.0,600,605,fhi:git
nation,Norge,2020-12-29,1068,0,1673,0,0.0311686085722057,0.0,1068,1673,fhi:git
nation,Norge,2020-12-30,422,0,2095,0,0.0390306246017758,0.0,422,2095,fhi:git
nation,Norge,2020-12-31,72,0,2167,0,0.0403720112229347,0.0,72,2167,fhi:git
nation,Norge,2021-01-01,6,0,2173,0,0.0404837934413646,0.0,6,2173,fhi:git
nation,Norge,2021-01-02,0,0,2173,0,0.0404837934413646,0.0,0,2173,fhi:git
nation,Norge,2021-01-03,0,0,2173,0,0.0404837934413646,0.0,0,2173,fhi:git
nation,Norge,2021-01-04,1,0,2174,0,0.040502423811103,0.0,1,2174,fhi:git
nation,Norge,2021-01-05,3421,0,5595,0,0.104236918685888,0.0,3421,5595,fhi:git
nation,Norge,2021-01-06,8998,0,14593,0,0.271872985591272,0.0,8998,14593,fhi:git
nation,Norge,2021-01-07,6546,0,21139,0,0.393827385898301,0.0,6546,21139,fhi:git
nation,Norge,2021-01-08,1614,0,22753,0,0.42389680265594604,0.0,1614,22753,fhi:git
nation,Norge,2021-01-09,132,0,22885,0,0.42635601146140295,0.0,132,22885,fhi:git
nation,Norge,2021-01-10,106,0,22991,0,0.428330830653665,0.0,106,22991,fhi:git
nation,Norge,2021-01-11,341,0,23332,0,0.434683786734432,0.0,341,23332,fhi:git
nation,Norge,2021-01-12,4277,0,27609,0,0.5143658781052171,0.0,4277,27609,fhi:git
nation,Norge,2021-01-13,9683,0,37292,0,0.6947637482813489,0.0,9683,37292,fhi:git
nation,Norge,2021-01-14,8375,0,45667,0,0.8507930948397601,0.0,8375,45667,fhi:git
nation,Norge,2021-01-15,4468,0,50135,0,0.9340335868305641,0.0,4468,50135,fhi:git
nation,Norge,2021-01-16,729,0,50864,0,0.947615126369798,0.0,729,50864,fhi:git
nation,Norge,2021-01-17,344,5,51208,5,0.9540239735597791,9.31518486915891e-05,349,51213,fhi:git
nation,Norge,2021-01-18,1259,283,52467,288,0.9774796090603208,0.005365546484635529,1542,52755,fhi:git
nation,Norge,2021-01-19,4521,767,56988,1055,1.06170751064726,0.0196550400739253,5288,58043,fhi:git
nation,Norge,2021-01-20,9851,690,66839,1745,1.24523528293943,0.0325099951933646,10541,68584,fhi:git
nation,Norge,2021-01-21,8172,167,75011,1912,1.39748266444096,0.0356212669396637,8339,76923,fhi:git
nation,Norge,2021-01-22,3222,7,78233,1919,1.45750971573782,0.0357516795278319,3229,80152,fhi:git
nation,Norge,2021-01-23,352,0,78585,1919,1.4640676058857098,0.0357516795278319,352,80504,fhi:git
nation,Norge,2021-01-24,65,0,78650,1919,1.4652785799186998,0.0357516795278319,65,80569,fhi:git
nation,Norge,2021-01-25,574,0,79224,1919,1.4759724121484898,0.0357516795278319,574,81143,fhi:git
nation,Norge,2021-01-26,2034,2034,81258,3953,1.5138665841962298,0.0736458515755704,4068,85211,fhi:git
nation,Norge,2021-01-27,10799,7325,92057,11278,1.71505594700032,0.21011330990874802,18124,103335,fhi:git
nation,Norge,2021-01-28,10324,6183,102381,17461,1.9073958841787202,0.325304886000768,16507,119842,fhi:git
nation,Norge,2021-01-29,3430,1952,105811,19413,1.9712980523811499,0.36167136772996394,5382,125224,fhi:git
nation,Norge,2021-01-30,111,164,105922,19577,1.9733660234221002,0.364726748367048,275,125499,fhi:git
nation,Norge,2021-01-31,80,49,106002,19626,1.9748564530011699,0.365639636484226,129,125628,fhi:git
nation,Norge,2021-02-01,109,294,106111,19920,1.97688716330264,0.371116965187291,403,126031,fhi:git
