granularity_geo,location_name,date,new_dose_1,new_dose_2,total_dose_1,total_dose_2,total_pr100_dose_1,total_pr100_dose_2,new_doses,total_doses,source
county,Oslo,2020-12-27,5,0,5,0,0.00072098677133472,0.0,5,5,fhi:git
county,Oslo,2020-12-28,264,0,269,0,0.0387890882978079,0.0,264,269,fhi:git
county,Oslo,2020-12-29,118,0,387,0,0.0558043761013073,0.0,118,387,fhi:git
county,Oslo,2020-12-30,58,0,445,0,0.06416782264879001,0.0,58,445,fhi:git
county,Oslo,2020-12-31,5,0,450,0,0.0648888094201248,0.0,5,450,fhi:git
county,Oslo,2021-01-01,6,0,456,0,0.0657539935457264,0.0,6,456,fhi:git
county,Oslo,2021-01-02,0,0,456,0,0.0657539935457264,0.0,0,456,fhi:git
county,Oslo,2021-01-03,0,0,456,0,0.0657539935457264,0.0,0,456,fhi:git
county,Oslo,2021-01-04,0,0,456,0,0.0657539935457264,0.0,0,456,fhi:git
county,Oslo,2021-01-05,480,0,936,0,0.13496872359386,0.0,480,936,fhi:git
county,Oslo,2021-01-06,605,0,1541,0,0.22220812292536102,0.0,605,1541,fhi:git
county,Oslo,2021-01-07,964,0,2505,0,0.361214372438695,0.0,964,2505,fhi:git
county,Oslo,2021-01-08,449,0,2954,0,0.42595898450455205,0.0,449,2954,fhi:git
county,Oslo,2021-01-09,126,0,3080,0,0.44412785114218706,0.0,126,3080,fhi:git
county,Oslo,2021-01-10,100,0,3180,0,0.458547586568882,0.0,100,3180,fhi:git
county,Oslo,2021-01-11,76,0,3256,0,0.469506585493169,0.0,76,3256,fhi:git
county,Oslo,2021-01-12,238,0,3494,0,0.503825555808702,0.0,238,3494,fhi:git
county,Oslo,2021-01-13,474,0,3968,0,0.5721751017312329,0.0,474,3968,fhi:git
county,Oslo,2021-01-14,1231,0,5199,0,0.7496820448338408,0.0,1231,5199,fhi:git
county,Oslo,2021-01-15,1654,0,6853,0,0.9881844687913671,0.0,1654,6853,fhi:git
county,Oslo,2021-01-16,632,0,7485,0,1.07931719668808,0.0,632,7485,fhi:git
county,Oslo,2021-01-17,277,5,7762,5,1.11925986382002,0.00072098677133472,282,7767,fhi:git
county,Oslo,2021-01-18,739,218,8501,223,1.22582170862329,0.0321560100015285,957,8724,fhi:git
county,Oslo,2021-01-19,807,69,9308,292,1.34218897351671,0.0421056274459476,876,9600,fhi:git
county,Oslo,2021-01-20,940,99,10248,391,1.4777344865276398,0.0563811655183751,1039,10639,fhi:git
county,Oslo,2021-01-21,971,21,11219,412,1.6177501175208402,0.0594093099579809,992,11631,fhi:git
county,Oslo,2021-01-22,662,6,11881,418,1.71320876604556,0.0602744940835826,668,12299,fhi:git
county,Oslo,2021-01-23,231,0,12112,418,1.7465183548812198,0.0602744940835826,231,12530,fhi:git
county,Oslo,2021-01-24,65,0,12177,418,1.75589118290858,0.0602744940835826,65,12595,fhi:git
county,Oslo,2021-01-25,257,0,12434,418,1.7929499029551799,0.0602744940835826,257,12852,fhi:git
county,Oslo,2021-01-26,278,402,12712,820,1.8330367674413899,0.118241830498894,680,13532,fhi:git
county,Oslo,2021-01-27,950,521,13662,1341,1.97002425399499,0.19336865207197196,1471,15003,fhi:git
county,Oslo,2021-01-28,804,775,14466,2116,2.0859589268256102,0.30512160162885305,1579,16582,fhi:git
county,Oslo,2021-01-29,351,493,14817,2609,2.1365721981733103,0.37621089728245705,844,17426,fhi:git
county,Oslo,2021-01-30,76,109,14893,2718,2.1475311970976003,0.391928408897554,185,17611,fhi:git
county,Oslo,2021-01-31,60,44,14953,2762,2.15618303835361,0.398273092485299,104,17715,fhi:git
county,Rogaland,2020-12-27,0,0,0,0,0.0,0.0,0,0,fhi:git
county,Rogaland,2020-12-28,0,0,0,0,0.0,0.0,0,0,fhi:git
county,Rogaland,2020-12-29,0,0,0,0,0.0,0.0,0,0,fhi:git
county,Rogaland,2020-12-30,0,0,0,0,0.0,0.0,0,0,fhi:git
county,Rogaland,2020-12-31,0,0,0,0,0.0,0.0,0,0,fhi:git
county,Rogaland,2021-01-01,0,0,0,0,0.0,0.0,0,0,fhi:git
county,Rogaland,2021-01-02,0,0,0,0,0.0,0.0,0,0,fhi:git
county,Rogaland,2021-01-03,0,0,0,0,0.0,0.0,0,0,fhi:git
county,Rogaland,2021-01-04,0,0,0,0,0.0,0.0,0,0,fhi:git
county,Rogaland,2021-01-05,548,0,548,0,0.11419235994765499,0.0,548,548,fhi:git
county,Rogaland,2021-01-06,641,0,1189,0,0.24776408025139,0.0,641,1189,fhi:git
county,Rogaland,2021-01-07,209,0,1398,0,0.29131554599785,0.0,209,1398,fhi:git
county,Rogaland,2021-01-08,21,0,1419,0,0.29569153059438397,0.0,21,1419,fhi:git
county,Rogaland,2021-01-09,0,0,1419,0,0.29569153059438397,0.0,0,1419,fhi:git
county,Rogaland,2021-01-10,0,0,1419,0,0.29569153059438397,0.0,0,1419,fhi:git
county,Rogaland,2021-01-11,1,0,1420,0,0.295899910813266,0.0,1,1420,fhi:git
county,Rogaland,2021-01-12,130,0,1550,0,0.32298933926800205,0.0,130,1550,fhi:git
county,Rogaland,2021-01-13,760,0,2310,0,0.481358305618764,0.0,760,2310,fhi:git
county,Rogaland,2021-01-14,522,0,2832,0,0.5901327798754721,0.0,522,2832,fhi:git
county,Rogaland,2021-01-15,287,0,3119,0,0.6499379026947729,0.0,287,3119,fhi:git
county,Rogaland,2021-01-16,0,0,3119,0,0.6499379026947729,0.0,0,3119,fhi:git
county,Rogaland,2021-01-17,0,0,3119,0,0.6499379026947729,0.0,0,3119,fhi:git
county,Rogaland,2021-01-18,71,0,3190,0,0.664732898235436,0.0,71,3190,fhi:git
county,Rogaland,2021-01-19,511,0,3701,0,0.771215190084436,0.0,511,3701,fhi:git
county,Rogaland,2021-01-20,616,0,4317,0,0.899577404916106,0.0,616,4317,fhi:git
county,Rogaland,2021-01-21,423,0,4740,0,0.987722237503438,0.0,423,4740,fhi:git
county,Rogaland,2021-01-22,265,0,5005,0,1.04294299550732,0.0,265,5005,fhi:git
county,Rogaland,2021-01-23,0,0,5005,0,1.04294299550732,0.0,0,5005,fhi:git
county,Rogaland,2021-01-24,0,0,5005,0,1.04294299550732,0.0,0,5005,fhi:git
county,Rogaland,2021-01-25,148,0,5153,0,1.07378326790194,0.0,148,5153,fhi:git
county,Rogaland,2021-01-26,335,381,5488,381,1.14359064122761,0.0793928633942637,716,5869,fhi:git
county,Rogaland,2021-01-27,818,599,6306,980,1.31404566027356,0.20421261450493,1417,7286,fhi:git
county,Rogaland,2021-01-28,491,262,6797,1242,1.4163603477449098,0.258808231852167,753,8039,fhi:git
county,Rogaland,2021-01-29,377,16,7174,1258,1.49491969026364,0.262142315354288,393,8432,fhi:git
county,Rogaland,2021-01-30,1,0,7175,1258,1.49512807048253,0.262142315354288,1,8433,fhi:git
county,Rogaland,2021-01-31,0,0,7175,1258,1.49512807048253,0.262142315354288,0,8433,fhi:git
county,Møre og Romsdal,2020-12-27,0,0,0,0,0.0,0.0,0,0,fhi:git
county,Møre og Romsdal,2020-12-28,0,0,0,0,0.0,0.0,0,0,fhi:git
county,Møre og Romsdal,2020-12-29,0,0,0,0,0.0,0.0,0,0,fhi:git
county,Møre og Romsdal,2020-12-30,0,0,0,0,0.0,0.0,0,0,fhi:git
county,Møre og Romsdal,2020-12-31,0,0,0,0,0.0,0.0,0,0,fhi:git
county,Møre og Romsdal,2021-01-01,0,0,0,0,0.0,0.0,0,0,fhi:git
county,Møre og Romsdal,2021-01-02,0,0,0,0,0.0,0.0,0,0,fhi:git
county,Møre og Romsdal,2021-01-03,0,0,0,0,0.0,0.0,0,0,fhi:git
county,Møre og Romsdal,2021-01-04,0,0,0,0,0.0,0.0,0,0,fhi:git
county,Møre og Romsdal,2021-01-05,186,0,186,0,0.0701256984293352,0.0,186,186,fhi:git
county,Møre og Romsdal,2021-01-06,497,0,683,0,0.257504580791591,0.0,497,683,fhi:git
county,Møre og Romsdal,2021-01-07,457,0,1140,0,0.429802667792699,0.0,457,1140,fhi:git
county,Møre og Romsdal,2021-01-08,35,0,1175,0,0.442998363733703,0.0,35,1175,fhi:git
county,Møre og Romsdal,2021-01-09,0,0,1175,0,0.442998363733703,0.0,0,1175,fhi:git
county,Møre og Romsdal,2021-01-10,0,0,1175,0,0.442998363733703,0.0,0,1175,fhi:git
county,Møre og Romsdal,2021-01-11,0,0,1175,0,0.442998363733703,0.0,0,1175,fhi:git
county,Møre og Romsdal,2021-01-12,227,0,1402,0,0.528581877408215,0.0,227,1402,fhi:git
county,Møre og Romsdal,2021-01-13,386,0,1788,0,0.674111552643286,0.0,386,1788,fhi:git
county,Møre og Romsdal,2021-01-14,404,0,2192,0,0.8264275857908749,0.0,404,2192,fhi:git
county,Møre og Romsdal,2021-01-15,152,0,2344,0,0.883734608163235,0.0,152,2344,fhi:git
county,Møre og Romsdal,2021-01-16,1,0,2345,0,0.8841116280472628,0.0,1,2345,fhi:git
county,Møre og Romsdal,2021-01-17,1,0,2346,0,0.884488647931292,0.0,1,2346,fhi:git
county,Møre og Romsdal,2021-01-18,11,0,2357,0,0.8886358666556071,0.0,11,2357,fhi:git
county,Møre og Romsdal,2021-01-19,163,0,2520,0,0.9500901077522829,0.0,163,2520,fhi:git
county,Møre og Romsdal,2021-01-20,487,0,3007,0,1.13369879127425,0.0,487,3007,fhi:git
county,Møre og Romsdal,2021-01-21,756,0,3763,0,1.41872582359994,0.0,756,3763,fhi:git
county,Møre og Romsdal,2021-01-22,209,0,3972,0,1.4975229793619298,0.0,209,3972,fhi:git
county,Møre og Romsdal,2021-01-23,0,0,3972,0,1.4975229793619298,0.0,0,3972,fhi:git
county,Møre og Romsdal,2021-01-24,0,0,3972,0,1.4975229793619298,0.0,0,3972,fhi:git
county,Møre og Romsdal,2021-01-25,3,0,3975,0,1.49865403901402,0.0,3,3975,fhi:git
county,Møre og Romsdal,2021-01-26,73,127,4048,127,1.52617649054811,0.0478815252716428,200,4175,fhi:git
county,Møre og Romsdal,2021-01-27,493,336,4541,463,1.7120472933742499,0.174560206305281,829,5004,fhi:git
county,Møre og Romsdal,2021-01-28,455,445,4996,908,1.8835913406073002,0.34233405469804495,900,5904,fhi:git
county,Møre og Romsdal,2021-01-29,78,66,5074,974,1.9129988915615401,0.367217367043938,144,6048,fhi:git
county,Møre og Romsdal,2021-01-30,0,0,5074,974,1.9129988915615401,0.367217367043938,0,6048,fhi:git
county,Møre og Romsdal,2021-01-31,0,0,5074,974,1.9129988915615401,0.367217367043938,0,6048,fhi:git
county,Nordland,2020-12-27,0,0,0,0,0.0,0.0,0,0,fhi:git
county,Nordland,2020-12-28,0,0,0,0,0.0,0.0,0,0,fhi:git
county,Nordland,2020-12-29,0,0,0,0,0.0,0.0,0,0,fhi:git
county,Nordland,2020-12-30,0,0,0,0,0.0,0.0,0,0,fhi:git
county,Nordland,2020-12-31,0,0,0,0,0.0,0.0,0,0,fhi:git
county,Nordland,2021-01-01,0,0,0,0,0.0,0.0,0,0,fhi:git
county,Nordland,2021-01-02,0,0,0,0,0.0,0.0,0,0,fhi:git
county,Nordland,2021-01-03,0,0,0,0,0.0,0.0,0,0,fhi:git
county,Nordland,2021-01-04,0,0,0,0,0.0,0.0,0,0,fhi:git
county,Nordland,2021-01-05,200,0,200,0,0.0829067092254441,0.0,200,200,fhi:git
county,Nordland,2021-01-06,687,0,887,0,0.367691255414845,0.0,687,887,fhi:git
county,Nordland,2021-01-07,238,0,1125,0,0.46635023939312303,0.0,238,1125,fhi:git
county,Nordland,2021-01-08,115,0,1240,0,0.514021597197753,0.0,115,1240,fhi:git
county,Nordland,2021-01-09,0,0,1240,0,0.514021597197753,0.0,0,1240,fhi:git
county,Nordland,2021-01-10,0,0,1240,0,0.514021597197753,0.0,0,1240,fhi:git
county,Nordland,2021-01-11,0,0,1240,0,0.514021597197753,0.0,0,1240,fhi:git
county,Nordland,2021-01-12,291,0,1531,0,0.6346508591207739,0.0,291,1531,fhi:git
county,Nordland,2021-01-13,602,0,2133,0,0.8842000538893611,0.0,602,2133,fhi:git
county,Nordland,2021-01-14,274,0,2407,0,0.997782245528219,0.0,274,2407,fhi:git
county,Nordland,2021-01-15,69,0,2476,0,1.026385060211,0.0,69,2476,fhi:git
county,Nordland,2021-01-16,0,0,2476,0,1.026385060211,0.0,0,2476,fhi:git
county,Nordland,2021-01-17,0,0,2476,0,1.026385060211,0.0,0,2476,fhi:git
county,Nordland,2021-01-18,0,0,2476,0,1.026385060211,0.0,0,2476,fhi:git
county,Nordland,2021-01-19,314,0,2790,0,1.15654859369494,0.0,314,2790,fhi:git
county,Nordland,2021-01-20,785,0,3575,0,1.4819574274048102,0.0,785,3575,fhi:git
county,Nordland,2021-01-21,615,0,4190,0,1.73689555827305,0.0,615,4190,fhi:git
county,Nordland,2021-01-22,165,0,4355,0,1.80529359338404,0.0,165,4355,fhi:git
county,Nordland,2021-01-23,1,0,4356,0,1.80570812693017,0.0,1,4356,fhi:git
county,Nordland,2021-01-24,0,0,4356,0,1.80570812693017,0.0,0,4356,fhi:git
county,Nordland,2021-01-25,51,0,4407,0,1.8268493377826598,0.0,51,4407,fhi:git
county,Nordland,2021-01-26,95,90,4502,90,1.86623002466475,0.0373080191514498,185,4592,fhi:git
county,Nordland,2021-01-27,603,511,5105,601,2.11619375297946,0.24913466122245898,1114,5706,fhi:git
county,Nordland,2021-01-28,453,333,5558,934,2.3039774493750897,0.387174332082824,786,6492,fhi:git
county,Nordland,2021-01-29,197,83,5755,1017,2.38564055796215,0.421580616411383,280,6772,fhi:git
county,Nordland,2021-01-30,0,0,5755,1017,2.38564055796215,0.421580616411383,0,6772,fhi:git
county,Nordland,2021-01-31,0,0,5755,1017,2.38564055796215,0.421580616411383,0,6772,fhi:git
county,Viken,2020-12-27,0,0,0,0,0.0,0.0,0,0,fhi:git
county,Viken,2020-12-28,64,0,64,0,0.0051564457586219395,0.0,64,64,fhi:git
county,Viken,2020-12-29,690,0,754,0,0.0607493765937647,0.0,690,754,fhi:git
county,Viken,2020-12-30,215,0,969,0,0.0780718115641353,0.0,215,969,fhi:git
county,Viken,2020-12-31,67,0,1036,0,0.0834699657176927,0.0,67,1036,fhi:git
county,Viken,2021-01-01,0,0,1036,0,0.0834699657176927,0.0,0,1036,fhi:git
county,Viken,2021-01-02,0,0,1036,0,0.0834699657176927,0.0,0,1036,fhi:git
county,Viken,2021-01-03,0,0,1036,0,0.0834699657176927,0.0,0,1036,fhi:git
county,Viken,2021-01-04,0,0,1036,0,0.0834699657176927,0.0,0,1036,fhi:git
county,Viken,2021-01-05,507,0,1543,0,0.124318684461776,0.0,507,1543,fhi:git
county,Viken,2021-01-06,1641,0,3184,0,0.25653317649144197,0.0,1641,3184,fhi:git
county,Viken,2021-01-07,1908,0,5092,0,0.41025971567035796,0.0,1908,5092,fhi:git
county,Viken,2021-01-08,266,0,5358,0,0.4316911933546311,0.0,266,5358,fhi:git
county,Viken,2021-01-09,6,0,5364,0,0.43217461014450104,0.0,6,5364,fhi:git
county,Viken,2021-01-10,4,0,5368,0,0.43249688800441494,0.0,4,5368,fhi:git
county,Viken,2021-01-11,55,0,5423,0,0.43692820857823106,0.0,55,5423,fhi:git
county,Viken,2021-01-12,747,0,6170,0,0.497113598917146,0.0,747,6170,fhi:git
county,Viken,2021-01-13,1925,0,8095,0,0.652209819000697,0.0,1925,8095,fhi:git
county,Viken,2021-01-14,1943,0,10038,0,0.8087562894538599,0.0,1943,10038,fhi:git
county,Viken,2021-01-15,1039,0,11077,0,0.8924679635664878,0.0,1039,11077,fhi:git
county,Viken,2021-01-16,85,0,11162,0,0.899316368089658,0.0,85,11162,fhi:git
county,Viken,2021-01-17,22,0,11184,0,0.9010888963191842,0.0,22,11184,fhi:git
county,Viken,2021-01-18,141,51,11325,51,0.912449190881148,0.00410904271390186,192,11376,fhi:git
county,Viken,2021-01-19,635,380,11960,431,0.963610801142475,0.0347254394057196,1015,12391,fhi:git
county,Viken,2021-01-20,1422,339,13382,770,1.07818058034186,0.0620384880334202,1761,14152,fhi:git
county,Viken,2021-01-21,1917,98,15299,868,1.23263224470558,0.0699342956013101,2015,16167,fhi:git
county,Viken,2021-01-22,795,1,16094,869,1.29668496936346,0.0700148650662885,796,16963,fhi:git
county,Viken,2021-01-23,97,0,16191,869,1.30450020746637,0.0700148650662885,97,17060,fhi:git
county,Viken,2021-01-24,0,0,16191,869,1.30450020746637,0.0700148650662885,0,17060,fhi:git
county,Viken,2021-01-25,59,0,16250,869,1.3092538059001002,0.0700148650662885,59,17119,fhi:git
county,Viken,2021-01-26,425,389,16675,1258,1.34349582851595,0.101356386942913,814,17933,fhi:git
county,Viken,2021-01-27,1716,1111,18391,2369,1.481753030419,0.19086906253399,2827,20760,fhi:git
county,Viken,2021-01-28,2861,1505,21252,3874,1.7122622697224,0.31212610732658397,4366,25126,fhi:git
county,Viken,2021-01-29,829,370,22081,4244,1.7790543561895502,0.34193680936861703,1199,26325,fhi:git
county,Viken,2021-01-30,1,17,22082,4261,1.77913492565453,0.343306490273251,18,26343,fhi:git
county,Viken,2021-01-31,0,3,22082,4264,1.77913492565453,0.34354819866818703,3,26346,fhi:git
county,Innlandet,2020-12-27,0,0,0,0,0.0,0.0,0,0,fhi:git
county,Innlandet,2020-12-28,271,0,271,0,0.07297009841539098,0.0,271,271,fhi:git
county,Innlandet,2020-12-29,260,0,531,0,0.142978310917242,0.0,260,531,fhi:git
county,Innlandet,2020-12-30,149,0,680,0,0.18309840192791801,0.0,149,680,fhi:git
county,Innlandet,2020-12-31,0,0,680,0,0.18309840192791801,0.0,0,680,fhi:git
county,Innlandet,2021-01-01,0,0,680,0,0.18309840192791801,0.0,0,680,fhi:git
county,Innlandet,2021-01-02,0,0,680,0,0.18309840192791801,0.0,0,680,fhi:git
county,Innlandet,2021-01-03,0,0,680,0,0.18309840192791801,0.0,0,680,fhi:git
county,Innlandet,2021-01-04,0,0,680,0,0.18309840192791801,0.0,0,680,fhi:git
county,Innlandet,2021-01-05,321,0,1001,0,0.269531618132127,0.0,321,1001,fhi:git
county,Innlandet,2021-01-06,650,0,1651,0,0.444552149386755,0.0,650,1651,fhi:git
county,Innlandet,2021-01-07,709,0,2360,0,0.635459159632188,0.0,709,2360,fhi:git
county,Innlandet,2021-01-08,76,0,2436,0,0.6559230986711899,0.0,76,2436,fhi:git
county,Innlandet,2021-01-09,0,0,2436,0,0.6559230986711899,0.0,0,2436,fhi:git
county,Innlandet,2021-01-10,0,0,2436,0,0.6559230986711899,0.0,0,2436,fhi:git
county,Innlandet,2021-01-11,51,0,2487,0,0.6696554788157839,0.0,51,2487,fhi:git
county,Innlandet,2021-01-12,440,0,2927,0,0.788130915357379,0.0,440,2927,fhi:git
county,Innlandet,2021-01-13,944,0,3871,0,1.04231457921025,0.0,944,3871,fhi:git
county,Innlandet,2021-01-14,939,0,4810,0,1.29515193128425,0.0,939,4810,fhi:git
county,Innlandet,2021-01-15,271,0,5081,0,1.36812202969964,0.0,271,5081,fhi:git
county,Innlandet,2021-01-16,4,0,5085,0,1.36919907912274,0.0,4,5085,fhi:git
county,Innlandet,2021-01-17,0,0,5085,0,1.36919907912274,0.0,0,5085,fhi:git
county,Innlandet,2021-01-18,67,0,5152,0,1.3872396569597598,0.0,67,5152,fhi:git
county,Innlandet,2021-01-19,331,318,5483,318,1.47636549672173,0.0856254291368795,649,5801,fhi:git
county,Innlandet,2021-01-20,640,252,6123,570,1.6486934044186001,0.15347954279252,892,6693,fhi:git
county,Innlandet,2021-01-21,826,48,6949,618,1.87110411028986,0.166404135869785,874,7567,fhi:git
county,Innlandet,2021-01-22,220,0,7169,618,1.93034182856066,0.166404135869785,220,7787,fhi:git
county,Innlandet,2021-01-23,5,0,7174,618,1.9316881403395398,0.166404135869785,5,7792,fhi:git
county,Innlandet,2021-01-24,0,0,7174,618,1.9316881403395398,0.166404135869785,0,7792,fhi:git
county,Innlandet,2021-01-25,2,0,7176,618,1.9322266650510902,0.166404135869785,2,7794,fhi:git
county,Innlandet,2021-01-26,141,130,7317,748,1.9701926572155601,0.20140824212070998,271,8065,fhi:git
county,Innlandet,2021-01-27,896,534,8213,1282,2.21145172799117,0.345194340105282,1430,9495,fhi:git
county,Innlandet,2021-01-28,813,678,9026,1960,2.4303620232373397,0.5277542173216471,1491,10986,fhi:git
county,Innlandet,2021-01-29,279,132,9305,2092,2.50548622049894,0.563296848284126,411,11397,fhi:git
county,Innlandet,2021-01-30,0,0,9305,2092,2.50548622049894,0.563296848284126,0,11397,fhi:git
county,Innlandet,2021-01-31,0,0,9305,2092,2.50548622049894,0.563296848284126,0,11397,fhi:git
county,Vestfold og Telemark,2020-12-27,0,0,0,0,0.0,0.0,0,0,fhi:git
county,Vestfold og Telemark,2020-12-28,0,0,0,0,0.0,0.0,0,0,fhi:git
county,Vestfold og Telemark,2020-12-29,0,0,0,0,0.0,0.0,0,0,fhi:git
county,Vestfold og Telemark,2020-12-30,0,0,0,0,0.0,0.0,0,0,fhi:git
county,Vestfold og Telemark,2020-12-31,0,0,0,0,0.0,0.0,0,0,fhi:git
county,Vestfold og Telemark,2021-01-01,0,0,0,0,0.0,0.0,0,0,fhi:git
county,Vestfold og Telemark,2021-01-02,0,0,0,0,0.0,0.0,0,0,fhi:git
county,Vestfold og Telemark,2021-01-03,0,0,0,0,0.0,0.0,0,0,fhi:git
county,Vestfold og Telemark,2021-01-04,0,0,0,0,0.0,0.0,0,0,fhi:git
county,Vestfold og Telemark,2021-01-05,218,0,218,0,0.0519795133954544,0.0,218,218,fhi:git
county,Vestfold og Telemark,2021-01-06,1025,0,1243,0,0.296378601608027,0.0,1025,1243,fhi:git
county,Vestfold og Telemark,2021-01-07,442,0,1685,0,0.401768257207985,0.0,442,1685,fhi:git
county,Vestfold og Telemark,2021-01-08,64,0,1749,0,0.41702829783784295,0.0,64,1749,fhi:git
county,Vestfold og Telemark,2021-01-09,0,0,1749,0,0.41702829783784295,0.0,0,1749,fhi:git
county,Vestfold og Telemark,2021-01-10,2,0,1751,0,0.417505174107526,0.0,2,1751,fhi:git
county,Vestfold og Telemark,2021-01-11,2,0,1753,0,0.417982050377209,0.0,2,1753,fhi:git
county,Vestfold og Telemark,2021-01-12,419,0,2172,0,0.517887628875812,0.0,419,2172,fhi:git
county,Vestfold og Telemark,2021-01-13,1154,0,3326,0,0.793045236482942,0.0,1154,3326,fhi:git
county,Vestfold og Telemark,2021-01-14,585,0,3911,0,0.93253154536524,0.0,585,3911,fhi:git
county,Vestfold og Telemark,2021-01-15,157,0,4068,0,0.96996633253536,0.0,157,4068,fhi:git
county,Vestfold og Telemark,2021-01-16,3,0,4071,0,0.970681646939885,0.0,3,4071,fhi:git
county,Vestfold og Telemark,2021-01-17,39,0,4110,0,0.9799807341987049,0.0,39,4110,fhi:git
county,Vestfold og Telemark,2021-01-18,5,0,4115,0,0.981172924872912,0.0,5,4115,fhi:git
county,Vestfold og Telemark,2021-01-19,226,0,4341,0,1.0350599433471,0.0,226,4341,fhi:git
county,Vestfold og Telemark,2021-01-20,1600,0,5941,0,1.4165609590935502,0.0,1600,5941,fhi:git
county,Vestfold og Telemark,2021-01-21,814,0,6755,0,1.61064960085456,0.0,814,6755,fhi:git
county,Vestfold og Telemark,2021-01-22,178,0,6933,0,1.65309158885636,0.0,178,6933,fhi:git
county,Vestfold og Telemark,2021-01-23,3,0,6936,0,1.6538069032608798,0.0,3,6936,fhi:git
county,Vestfold og Telemark,2021-01-24,0,0,6936,0,1.6538069032608798,0.0,0,6936,fhi:git
county,Vestfold og Telemark,2021-01-25,45,0,6981,0,1.66453661932875,0.0,45,6981,fhi:git
county,Vestfold og Telemark,2021-01-26,90,131,7071,131,1.68599605146449,0.031235395664241,221,7202,fhi:git
county,Vestfold og Telemark,2021-01-27,1591,873,8662,1004,2.06535112399737,0.2393918873809,2464,9666,fhi:git
county,Vestfold og Telemark,2021-01-28,628,443,9290,1447,2.21509027267785,0.3450199811157,1071,10737,fhi:git
county,Vestfold og Telemark,2021-01-29,74,85,9364,1532,2.2327346946561204,0.36528722257722995,159,10896,fhi:git
county,Vestfold og Telemark,2021-01-30,0,0,9364,1532,2.2327346946561204,0.36528722257722995,0,10896,fhi:git
county,Vestfold og Telemark,2021-01-31,0,1,9364,1533,2.2327346946561204,0.36552566071207204,1,10897,fhi:git
county,Agder,2020-12-27,0,0,0,0,0.0,0.0,0,0,fhi:git
county,Agder,2020-12-28,0,0,0,0,0.0,0.0,0,0,fhi:git
county,Agder,2020-12-29,0,0,0,0,0.0,0.0,0,0,fhi:git
county,Agder,2020-12-30,0,0,0,0,0.0,0.0,0,0,fhi:git
county,Agder,2020-12-31,0,0,0,0,0.0,0.0,0,0,fhi:git
county,Agder,2021-01-01,0,0,0,0,0.0,0.0,0,0,fhi:git
county,Agder,2021-01-02,0,0,0,0,0.0,0.0,0,0,fhi:git
county,Agder,2021-01-03,0,0,0,0,0.0,0.0,0,0,fhi:git
county,Agder,2021-01-04,0,0,0,0,0.0,0.0,0,0,fhi:git
county,Agder,2021-01-05,79,0,79,0,0.0257135510413988,0.0,79,79,fhi:git
county,Agder,2021-01-06,791,0,870,0,0.283174549443253,0.0,791,870,fhi:git
county,Agder,2021-01-07,230,0,1100,0,0.35803678665238897,0.0,230,1100,fhi:git
county,Agder,2021-01-08,49,0,1149,0,0.37398569805781295,0.0,49,1149,fhi:git
county,Agder,2021-01-09,0,0,1149,0,0.37398569805781295,0.0,0,1149,fhi:git
county,Agder,2021-01-10,0,0,1149,0,0.37398569805781295,0.0,0,1149,fhi:git
county,Agder,2021-01-11,0,0,1149,0,0.37398569805781295,0.0,0,1149,fhi:git
county,Agder,2021-01-12,225,0,1374,0,0.44722049532762,0.0,225,1374,fhi:git
county,Agder,2021-01-13,851,0,2225,0,0.724210773001422,0.0,851,2225,fhi:git
county,Agder,2021-01-14,499,0,2724,0,0.8866292789464609,0.0,499,2724,fhi:git
county,Agder,2021-01-15,118,0,2842,0,0.9250368615146259,0.0,118,2842,fhi:git
county,Agder,2021-01-16,0,0,2842,0,0.9250368615146259,0.0,0,2842,fhi:git
county,Agder,2021-01-17,2,0,2844,0,0.9256878374903579,0.0,2,2844,fhi:git
county,Agder,2021-01-18,15,0,2859,0,0.9305701573083441,0.0,15,2859,fhi:git
county,Agder,2021-01-19,348,0,3207,0,1.04383997708565,0.0,348,3207,fhi:git
county,Agder,2021-01-20,452,0,3659,0,1.19096054760099,0.0,452,3659,fhi:git
county,Agder,2021-01-21,333,0,3992,0,1.2993480475603,0.0,333,3992,fhi:git
county,Agder,2021-01-22,55,0,4047,0,1.3172498868929199,0.0,55,4047,fhi:git
county,Agder,2021-01-23,1,0,4048,0,1.31757537488079,0.0,1,4048,fhi:git
county,Agder,2021-01-24,0,0,4048,0,1.31757537488079,0.0,0,4048,fhi:git
county,Agder,2021-01-25,1,0,4049,0,1.31790086286866,0.0,1,4049,fhi:git
county,Agder,2021-01-26,62,66,4111,66,1.3380811181163401,0.0214822071991433,128,4177,fhi:git
county,Agder,2021-01-27,535,674,4646,740,1.5122171916245402,0.240861111020698,1209,5386,fhi:git
county,Agder,2021-01-28,858,248,5504,988,1.79148588521341,0.32158213201141805,1106,6492,fhi:git
county,Agder,2021-01-29,183,57,5687,1045,1.85105018699285,0.34013494731976895,240,6732,fhi:git
county,Agder,2021-01-30,29,0,5716,1045,1.8604893386409598,0.34013494731976895,29,6761,fhi:git
county,Agder,2021-01-31,20,0,5736,1045,1.86699909839827,0.34013494731976895,20,6781,fhi:git
county,Vestland,2020-12-27,0,0,0,0,0.0,0.0,0,0,fhi:git
county,Vestland,2020-12-28,0,0,0,0,0.0,0.0,0,0,fhi:git
county,Vestland,2020-12-29,0,0,0,0,0.0,0.0,0,0,fhi:git
county,Vestland,2020-12-30,0,0,0,0,0.0,0.0,0,0,fhi:git
county,Vestland,2020-12-31,0,0,0,0,0.0,0.0,0,0,fhi:git
county,Vestland,2021-01-01,0,0,0,0,0.0,0.0,0,0,fhi:git
county,Vestland,2021-01-02,0,0,0,0,0.0,0.0,0,0,fhi:git
county,Vestland,2021-01-03,0,0,0,0,0.0,0.0,0,0,fhi:git
county,Vestland,2021-01-04,1,0,1,0,0.00015710153943798502,0.0,1,1,fhi:git
county,Vestland,2021-01-05,416,0,417,0,0.0655113419456397,0.0,416,417,fhi:git
county,Vestland,2021-01-06,1248,0,1665,0,0.261574063164245,0.0,1248,1665,fhi:git
county,Vestland,2021-01-07,715,0,2380,0,0.373901663862404,0.0,715,2380,fhi:git
county,Vestland,2021-01-08,138,0,2518,0,0.39558167630484603,0.0,138,2518,fhi:git
county,Vestland,2021-01-09,0,0,2518,0,0.39558167630484603,0.0,0,2518,fhi:git
county,Vestland,2021-01-10,0,0,2518,0,0.39558167630484603,0.0,0,2518,fhi:git
county,Vestland,2021-01-11,59,0,2577,0,0.40485066713168705,0.0,59,2577,fhi:git
county,Vestland,2021-01-12,853,0,3430,0,0.538858280272288,0.0,853,3430,fhi:git
county,Vestland,2021-01-13,1122,0,4552,0,0.715126207521708,0.0,1122,4552,fhi:git
county,Vestland,2021-01-14,966,0,5518,0,0.8668862946188008,0.0,966,5518,fhi:git
county,Vestland,2021-01-15,421,0,5939,0,0.933026042722193,0.0,421,5939,fhi:git
county,Vestland,2021-01-16,2,0,5941,0,0.933340245801068,0.0,2,5941,fhi:git
county,Vestland,2021-01-17,1,0,5942,0,0.933497347340506,0.0,1,5942,fhi:git
county,Vestland,2021-01-18,54,0,5996,0,0.941980830470158,0.0,54,5996,fhi:git
county,Vestland,2021-01-19,364,0,6360,0,0.9991657908255841,0.0,364,6360,fhi:git
county,Vestland,2021-01-20,1235,0,7595,0,1.1931861920315001,0.0,1235,7595,fhi:git
county,Vestland,2021-01-21,766,0,8361,0,1.31352597124099,0.0,766,8361,fhi:git
county,Vestland,2021-01-22,303,0,8664,0,1.3611277376907,0.0,303,8664,fhi:git
county,Vestland,2021-01-23,0,0,8664,0,1.3611277376907,0.0,0,8664,fhi:git
county,Vestland,2021-01-24,0,0,8664,0,1.3611277376907,0.0,0,8664,fhi:git
county,Vestland,2021-01-25,1,0,8665,0,1.3612848392301398,0.0,1,8665,fhi:git
county,Vestland,2021-01-26,143,103,8808,103,1.38375035936977,0.0161814585621125,246,8911,fhi:git
county,Vestland,2021-01-27,1501,1067,10309,1170,1.6195597700661901,0.183808801142442,2568,11479,fhi:git
county,Vestland,2021-01-28,1828,613,12137,1783,1.90674138415882,0.280112044817927,2441,13920,fhi:git
county,Vestland,2021-01-29,441,124,12578,1907,1.97602316305097,0.29959263570823697,565,14485,fhi:git
county,Vestland,2021-01-30,0,0,12578,1907,1.97602316305097,0.29959263570823697,0,14485,fhi:git
county,Vestland,2021-01-31,0,0,12578,1907,1.97602316305097,0.29959263570823697,0,14485,fhi:git
county,Trøndelag,2020-12-27,0,0,0,0,0.0,0.0,0,0,fhi:git
county,Trøndelag,2020-12-28,0,0,0,0,0.0,0.0,0,0,fhi:git
county,Trøndelag,2020-12-29,0,0,0,0,0.0,0.0,0,0,fhi:git
county,Trøndelag,2020-12-30,0,0,0,0,0.0,0.0,0,0,fhi:git
county,Trøndelag,2020-12-31,0,0,0,0,0.0,0.0,0,0,fhi:git
county,Trøndelag,2021-01-01,0,0,0,0,0.0,0.0,0,0,fhi:git
county,Trøndelag,2021-01-02,0,0,0,0,0.0,0.0,0,0,fhi:git
county,Trøndelag,2021-01-03,0,0,0,0,0.0,0.0,0,0,fhi:git
county,Trøndelag,2021-01-04,0,0,0,0,0.0,0.0,0,0,fhi:git
county,Trøndelag,2021-01-05,411,0,411,0,0.0876889793514856,0.0,411,411,fhi:git
county,Trøndelag,2021-01-06,674,0,1085,0,0.231490371280686,0.0,674,1085,fhi:git
county,Trøndelag,2021-01-07,482,0,1567,0,0.334327568476345,0.0,482,1567,fhi:git
county,Trøndelag,2021-01-08,140,0,1707,0,0.364197293802885,0.0,140,1707,fhi:git
county,Trøndelag,2021-01-09,0,0,1707,0,0.364197293802885,0.0,0,1707,fhi:git
county,Trøndelag,2021-01-10,0,0,1707,0,0.364197293802885,0.0,0,1707,fhi:git
county,Trøndelag,2021-01-11,95,0,1802,0,0.384466035988752,0.0,95,1802,fhi:git
county,Trøndelag,2021-01-12,498,0,2300,0,0.49071691607887297,0.0,498,2300,fhi:git
county,Trøndelag,2021-01-13,863,0,3163,0,0.6748424371989019,0.0,863,3163,fhi:git
county,Trøndelag,2021-01-14,666,0,3829,0,0.8169369876808721,0.0,666,3829,fhi:git
county,Trøndelag,2021-01-15,253,0,4082,0,0.8709158484495481,0.0,253,4082,fhi:git
county,Trøndelag,2021-01-16,0,0,4082,0,0.8709158484495481,0.0,0,4082,fhi:git
county,Trøndelag,2021-01-17,0,0,4082,0,0.8709158484495481,0.0,0,4082,fhi:git
county,Trøndelag,2021-01-18,155,0,4237,0,0.903985901489646,0.0,155,4237,fhi:git
county,Trøndelag,2021-01-19,568,0,4805,0,1.02517164424304,0.0,568,4805,fhi:git
county,Trøndelag,2021-01-20,734,0,5539,0,1.18177434702647,0.0,734,5539,fhi:git
county,Trøndelag,2021-01-21,495,0,6034,0,1.2873851615738798,0.0,495,6034,fhi:git
county,Trøndelag,2021-01-22,284,0,6318,0,1.34797803295057,0.0,284,6318,fhi:git
county,Trøndelag,2021-01-23,1,0,6319,0,1.34819138813148,0.0,1,6319,fhi:git
county,Trøndelag,2021-01-24,0,0,6319,0,1.34819138813148,0.0,0,6319,fhi:git
county,Trøndelag,2021-01-25,1,0,6320,0,1.34840474331238,0.0,1,6320,fhi:git
county,Trøndelag,2021-01-26,287,173,6607,173,1.40963768023179,0.0369104462963674,460,6780,fhi:git
county,Trøndelag,2021-01-27,931,575,7538,748,1.6082713536532802,0.159589675316086,1506,8286,fhi:git
county,Trøndelag,2021-01-28,663,442,8201,1190,1.74972583859254,0.253892665275591,1105,9391,fhi:git
county,Trøndelag,2021-01-29,313,162,8514,1352,1.81650601021545,0.288456204582016,475,9866,fhi:git
county,Trøndelag,2021-01-30,0,0,8514,1352,1.81650601021545,0.288456204582016,0,9866,fhi:git
county,Trøndelag,2021-01-31,0,1,8514,1353,1.81650601021545,0.28866955976291997,1,9867,fhi:git
county,Troms og Finnmark,2020-12-27,0,0,0,0,0.0,0.0,0,0,fhi:git
county,Troms og Finnmark,2020-12-28,1,0,1,0,0.00041099662571770297,0.0,1,1,fhi:git
county,Troms og Finnmark,2020-12-29,0,0,1,0,0.00041099662571770297,0.0,0,1,fhi:git
county,Troms og Finnmark,2020-12-30,0,0,1,0,0.00041099662571770297,0.0,0,1,fhi:git
county,Troms og Finnmark,2020-12-31,0,0,1,0,0.00041099662571770297,0.0,0,1,fhi:git
county,Troms og Finnmark,2021-01-01,0,0,1,0,0.00041099662571770297,0.0,0,1,fhi:git
county,Troms og Finnmark,2021-01-02,0,0,1,0,0.00041099662571770297,0.0,0,1,fhi:git
county,Troms og Finnmark,2021-01-03,0,0,1,0,0.00041099662571770297,0.0,0,1,fhi:git
county,Troms og Finnmark,2021-01-04,0,0,1,0,0.00041099662571770297,0.0,0,1,fhi:git
county,Troms og Finnmark,2021-01-05,53,0,54,0,0.022193817788756,0.0,53,54,fhi:git
county,Troms og Finnmark,2021-01-06,529,0,583,0,0.23961103279342102,0.0,529,583,fhi:git
county,Troms og Finnmark,2021-01-07,188,0,771,0,0.31687839842834903,0.0,188,771,fhi:git
county,Troms og Finnmark,2021-01-08,248,0,1019,0,0.41880556160633897,0.0,248,1019,fhi:git
county,Troms og Finnmark,2021-01-09,0,0,1019,0,0.41880556160633897,0.0,0,1019,fhi:git
county,Troms og Finnmark,2021-01-10,0,0,1019,0,0.41880556160633897,0.0,0,1019,fhi:git
county,Troms og Finnmark,2021-01-11,1,0,1020,0,0.419216558232057,0.0,1,1020,fhi:git
county,Troms og Finnmark,2021-01-12,189,0,1209,0,0.49689492049270295,0.0,189,1209,fhi:git
county,Troms og Finnmark,2021-01-13,574,0,1783,0,0.732806983654664,0.0,574,1783,fhi:git
county,Troms og Finnmark,2021-01-14,329,0,2112,0,0.868024873515788,0.0,329,2112,fhi:git
county,Troms og Finnmark,2021-01-15,37,0,2149,0,0.8832317486673441,0.0,37,2149,fhi:git
county,Troms og Finnmark,2021-01-16,2,0,2151,0,0.8840537419187791,0.0,2,2151,fhi:git
county,Troms og Finnmark,2021-01-17,1,0,2152,0,0.884464738544497,0.0,1,2152,fhi:git
county,Troms og Finnmark,2021-01-18,0,1,2152,1,0.884464738544497,0.00041099662571770297,1,2153,fhi:git
county,Troms og Finnmark,2021-01-19,248,0,2400,1,0.986391901722487,0.00041099662571770297,248,2401,fhi:git
county,Troms og Finnmark,2021-01-20,907,0,3307,1,1.3591658412484398,0.00041099662571770297,907,3308,fhi:git
county,Troms og Finnmark,2021-01-21,247,0,3554,1,1.46068200780072,0.00041099662571770297,247,3555,fhi:git
county,Troms og Finnmark,2021-01-22,80,0,3634,1,1.4935617378581298,0.00041099662571770297,80,3635,fhi:git
county,Troms og Finnmark,2021-01-23,12,0,3646,1,1.4984936973667402,0.00041099662571770297,12,3647,fhi:git
county,Troms og Finnmark,2021-01-24,0,0,3646,1,1.4984936973667402,0.00041099662571770297,0,3647,fhi:git
county,Troms og Finnmark,2021-01-25,6,0,3652,1,1.50095967712105,0.00041099662571770297,6,3653,fhi:git
county,Troms og Finnmark,2021-01-26,71,0,3723,1,1.5301404375470098,0.00041099662571770297,71,3724,fhi:git
county,Troms og Finnmark,2021-01-27,657,336,4380,337,1.8001652206435401,0.138505862866866,993,4717,fhi:git
county,Troms og Finnmark,2021-01-28,184,236,4564,573,1.8757885997756,0.235501066536244,420,5137,fhi:git
county,Troms og Finnmark,2021-01-29,102,236,4666,809,1.9177102555988002,0.332496270205622,338,5475,fhi:git
county,Troms og Finnmark,2021-01-30,0,0,4666,809,1.9177102555988002,0.332496270205622,0,5475,fhi:git
county,Troms og Finnmark,2021-01-31,0,0,4666,809,1.9177102555988002,0.332496270205622,0,5475,fhi:git
nation,Norge,2020-12-27,5,0,5,0,9.31518486915891e-05,0.0,5,5,fhi:git
nation,Norge,2020-12-28,600,0,605,0,0.0112713736916823,0.0,600,605,fhi:git
nation,Norge,2020-12-29,1068,0,1673,0,0.0311686085722057,0.0,1068,1673,fhi:git
nation,Norge,2020-12-30,422,0,2095,0,0.0390306246017758,0.0,422,2095,fhi:git
nation,Norge,2020-12-31,72,0,2167,0,0.0403720112229347,0.0,72,2167,fhi:git
nation,Norge,2021-01-01,6,0,2173,0,0.0404837934413646,0.0,6,2173,fhi:git
nation,Norge,2021-01-02,0,0,2173,0,0.0404837934413646,0.0,0,2173,fhi:git
nation,Norge,2021-01-03,0,0,2173,0,0.0404837934413646,0.0,0,2173,fhi:git
nation,Norge,2021-01-04,1,0,2174,0,0.040502423811103,0.0,1,2174,fhi:git
nation,Norge,2021-01-05,3421,0,5595,0,0.104236918685888,0.0,3421,5595,fhi:git
nation,Norge,2021-01-06,8998,0,14593,0,0.271872985591272,0.0,8998,14593,fhi:git
nation,Norge,2021-01-07,6544,0,21137,0,0.39379012515882394,0.0,6544,21137,fhi:git
nation,Norge,2021-01-08,1601,0,22738,0,0.42361734710987103,0.0,1601,22738,fhi:git
nation,Norge,2021-01-09,132,0,22870,0,0.426076555915329,0.0,132,22870,fhi:git
nation,Norge,2021-01-10,106,0,22976,0,0.42805137510759006,0.0,106,22976,fhi:git
nation,Norge,2021-01-11,341,0,23317,0,0.43440433118835703,0.0,341,23317,fhi:git
nation,Norge,2021-01-12,4258,0,27575,0,0.513732445534114,0.0,4258,27575,fhi:git
nation,Norge,2021-01-13,9660,0,37235,0,0.693701817206264,0.0,9660,37235,fhi:git
nation,Norge,2021-01-14,8373,0,45608,0,0.849693903025199,0.0,8373,45608,fhi:git
nation,Norge,2021-01-15,4468,0,50076,0,0.932934395016003,0.0,4468,50076,fhi:git
nation,Norge,2021-01-16,729,0,50805,0,0.946515934555237,0.0,729,50805,fhi:git
nation,Norge,2021-01-17,344,5,51149,5,0.9529247817452191,9.31518486915891e-05,349,51154,fhi:git
nation,Norge,2021-01-18,1259,270,52408,275,0.976380417245761,0.0051233516780374,1529,52683,fhi:git
nation,Norge,2021-01-19,4520,767,56928,1042,1.06058968846296,0.0194128452673272,5287,57970,fhi:git
nation,Norge,2021-01-20,9829,690,66757,1732,1.2437075926208798,0.0322678003867665,10519,68489,fhi:git
nation,Norge,2021-01-21,8172,167,74929,1899,1.39595497412242,0.0353790721330656,8339,76828,fhi:git
nation,Norge,2021-01-22,3220,7,78149,1906,1.4559447646798,0.0355094847212338,3227,80055,fhi:git
nation,Norge,2021-01-23,352,0,78501,1906,1.4625026548276898,0.0355094847212338,352,80407,fhi:git
nation,Norge,2021-01-24,65,0,78566,1906,1.4637136288606798,0.0355094847212338,65,80472,fhi:git
nation,Norge,2021-01-25,574,0,79140,1906,1.47440746109047,0.0355094847212338,574,81046,fhi:git
nation,Norge,2021-01-26,2000,1994,81140,3900,1.5116682005671103,0.0726584419794395,3994,85040,fhi:git
nation,Norge,2021-01-27,10700,7142,91840,11042,1.7110131567671103,0.205716542650505,17842,102882,fhi:git
nation,Norge,2021-01-28,10045,5983,101885,17025,1.8981552207885102,0.31718204479486106,16028,118910,fhi:git
nation,Norge,2021-01-29,3229,1825,105114,18850,1.95831268467354,0.351182469567291,5054,123964,fhi:git
nation,Norge,2021-01-30,107,126,105221,18976,1.9603061342355401,0.35352989615431896,233,124197,fhi:git
nation,Norge,2021-01-31,80,49,105301,19025,1.9617965638146102,0.354442784271497,129,124326,fhi:git
