granularity_geo,location_name,date,new_dose_1,new_dose_2,total_dose_1,total_dose_2,total_pr100_dose_1,total_pr100_dose_2,new_doses,total_doses,source
county,Oslo,2020-12-27,5,0,5,0,0.00072098677133472,0.0,5,5,fhi:git
county,Oslo,2020-12-28,264,0,269,0,0.0387890882978079,0.0,264,269,fhi:git
county,Oslo,2020-12-29,118,0,387,0,0.0558043761013073,0.0,118,387,fhi:git
county,Oslo,2020-12-30,58,0,445,0,0.06416782264879001,0.0,58,445,fhi:git
county,Oslo,2020-12-31,5,0,450,0,0.0648888094201248,0.0,5,450,fhi:git
county,Oslo,2021-01-01,6,0,456,0,0.0657539935457264,0.0,6,456,fhi:git
county,Oslo,2021-01-02,0,0,456,0,0.0657539935457264,0.0,0,456,fhi:git
county,Oslo,2021-01-03,0,0,456,0,0.0657539935457264,0.0,0,456,fhi:git
county,Oslo,2021-01-04,0,0,456,0,0.0657539935457264,0.0,0,456,fhi:git
county,Oslo,2021-01-05,480,0,936,0,0.13496872359386,0.0,480,936,fhi:git
county,Oslo,2021-01-06,605,0,1541,0,0.22220812292536102,0.0,605,1541,fhi:git
county,Oslo,2021-01-07,967,0,2508,0,0.36164696450149497,0.0,967,2508,fhi:git
county,Oslo,2021-01-08,449,0,2957,0,0.42639157656735294,0.0,449,2957,fhi:git
county,Oslo,2021-01-09,126,0,3083,0,0.44456044320498794,0.0,126,3083,fhi:git
county,Oslo,2021-01-10,100,0,3183,0,0.458980178631683,0.0,100,3183,fhi:git
county,Oslo,2021-01-11,76,0,3259,0,0.46993917755597,0.0,76,3259,fhi:git
county,Oslo,2021-01-12,239,0,3498,0,0.50440234522577,0.0,239,3498,fhi:git
county,Oslo,2021-01-13,488,0,3986,0,0.574770654108038,0.0,488,3986,fhi:git
county,Oslo,2021-01-14,1231,0,5217,0,0.752277597210646,0.0,1231,5217,fhi:git
county,Oslo,2021-01-15,1654,0,6871,0,0.9907800211681721,0.0,1654,6871,fhi:git
county,Oslo,2021-01-16,636,0,7507,0,1.08248953848195,0.0,636,7507,fhi:git
county,Oslo,2021-01-17,277,5,7784,5,1.1224322056138898,0.00072098677133472,282,7789,fhi:git
county,Oslo,2021-01-18,739,231,8523,236,1.22899405041716,0.0340305756069988,970,8759,fhi:git
county,Oslo,2021-01-19,806,69,9329,305,1.3452171179563202,0.0439801930514179,875,9634,fhi:git
county,Oslo,2021-01-20,985,99,10314,404,1.4872515119092602,0.0582557311238453,1084,10718,fhi:git
county,Oslo,2021-01-21,1017,21,11331,425,1.63390022119874,0.0612838755634512,1038,11756,fhi:git
county,Oslo,2021-01-22,668,6,11999,431,1.7302240538490599,0.0621490596890528,674,12430,fhi:git
county,Oslo,2021-01-23,232,0,12231,431,1.76367784003899,0.0621490596890528,232,12662,fhi:git
county,Oslo,2021-01-24,65,0,12296,431,1.77305066806634,0.0621490596890528,65,12727,fhi:git
county,Oslo,2021-01-25,257,0,12553,431,1.81010938811295,0.0621490596890528,257,12984,fhi:git
county,Oslo,2021-01-26,315,402,12868,833,1.8555315547070301,0.120116396104364,717,13701,fhi:git
county,Oslo,2021-01-27,996,524,13864,1357,1.9991521195569097,0.19567580974024298,1520,15221,fhi:git
county,Oslo,2021-01-28,833,841,14697,2198,2.11926851566127,0.316945784678743,1674,16895,fhi:git
county,Oslo,2021-01-29,409,500,15106,2698,2.17824523355645,0.389044461812215,909,17804,fhi:git
county,Oslo,2021-01-30,92,149,15198,2847,2.19151139014901,0.410529867597989,241,18045,fhi:git
county,Oslo,2021-01-31,60,45,15258,2892,2.2001632314050297,0.41701874854000204,105,18150,fhi:git
county,Oslo,2021-02-01,51,46,15309,2938,2.20751729647264,0.423651826836281,97,18247,fhi:git
county,Oslo,2021-02-02,1471,148,16780,3086,2.41963160459932,0.444993035267789,1619,19866,fhi:git
county,Oslo,2021-02-03,2174,298,18954,3384,2.73311665277565,0.48796384683933797,2472,22338,fhi:git
county,Rogaland,2020-12-27,0,0,0,0,0.0,0.0,0,0,fhi:git
county,Rogaland,2020-12-28,1,0,1,0,0.00020838021888258202,0.0,1,1,fhi:git
county,Rogaland,2020-12-29,0,0,1,0,0.00020838021888258202,0.0,0,1,fhi:git
county,Rogaland,2020-12-30,0,0,1,0,0.00020838021888258202,0.0,0,1,fhi:git
county,Rogaland,2020-12-31,0,0,1,0,0.00020838021888258202,0.0,0,1,fhi:git
county,Rogaland,2021-01-01,0,0,1,0,0.00020838021888258202,0.0,0,1,fhi:git
county,Rogaland,2021-01-02,0,0,1,0,0.00020838021888258202,0.0,0,1,fhi:git
county,Rogaland,2021-01-03,0,0,1,0,0.00020838021888258202,0.0,0,1,fhi:git
county,Rogaland,2021-01-04,0,0,1,0,0.00020838021888258202,0.0,0,1,fhi:git
county,Rogaland,2021-01-05,548,0,549,0,0.11440074016653698,0.0,548,549,fhi:git
county,Rogaland,2021-01-06,641,0,1190,0,0.24797246047027302,0.0,641,1190,fhi:git
county,Rogaland,2021-01-07,210,0,1400,0,0.291732306435615,0.0,210,1400,fhi:git
county,Rogaland,2021-01-08,20,0,1420,0,0.295899910813266,0.0,20,1420,fhi:git
county,Rogaland,2021-01-09,0,0,1420,0,0.295899910813266,0.0,0,1420,fhi:git
county,Rogaland,2021-01-10,0,0,1420,0,0.295899910813266,0.0,0,1420,fhi:git
county,Rogaland,2021-01-11,1,0,1421,0,0.296108291032149,0.0,1,1421,fhi:git
county,Rogaland,2021-01-12,129,0,1550,0,0.32298933926800205,0.0,129,1550,fhi:git
county,Rogaland,2021-01-13,761,0,2311,0,0.481566685837647,0.0,761,2311,fhi:git
county,Rogaland,2021-01-14,523,0,2834,0,0.590549540313237,0.0,523,2834,fhi:git
county,Rogaland,2021-01-15,288,0,3122,0,0.650563043351421,0.0,288,3122,fhi:git
county,Rogaland,2021-01-16,0,0,3122,0,0.650563043351421,0.0,0,3122,fhi:git
county,Rogaland,2021-01-17,0,0,3122,0,0.650563043351421,0.0,0,3122,fhi:git
county,Rogaland,2021-01-18,71,0,3193,0,0.665358038892084,0.0,71,3193,fhi:git
county,Rogaland,2021-01-19,511,0,3704,0,0.771840330741083,0.0,511,3704,fhi:git
county,Rogaland,2021-01-20,616,0,4320,0,0.900202545572754,0.0,616,4320,fhi:git
county,Rogaland,2021-01-21,424,0,4744,0,0.9885557583789691,0.0,424,4744,fhi:git
county,Rogaland,2021-01-22,266,0,5010,0,1.04398489660174,0.0,266,5010,fhi:git
county,Rogaland,2021-01-23,0,0,5010,0,1.04398489660174,0.0,0,5010,fhi:git
county,Rogaland,2021-01-24,0,0,5010,0,1.04398489660174,0.0,0,5010,fhi:git
county,Rogaland,2021-01-25,148,0,5158,0,1.07482516899636,0.0,148,5158,fhi:git
county,Rogaland,2021-01-26,336,380,5494,380,1.14484092254091,0.0791844831753811,716,5874,fhi:git
county,Rogaland,2021-01-27,820,599,6314,979,1.3157127020246202,0.204004234286048,1419,7293,fhi:git
county,Rogaland,2021-01-28,503,282,6817,1261,1.4205279521225602,0.26276745601093604,785,8078,fhi:git
county,Rogaland,2021-01-29,403,22,7220,1283,1.5045051803322398,0.267351820826353,425,8503,fhi:git
county,Rogaland,2021-01-30,2,0,7222,1283,1.50492194077001,0.267351820826353,2,8505,fhi:git
county,Rogaland,2021-01-31,0,0,7222,1283,1.50492194077001,0.267351820826353,0,8505,fhi:git
county,Rogaland,2021-02-01,13,5,7235,1288,1.5076308836154801,0.268393721920766,18,8523,fhi:git
county,Rogaland,2021-02-02,432,75,7667,1363,1.59765113817276,0.284022238336959,507,9030,fhi:git
county,Rogaland,2021-02-03,2086,505,9753,1868,2.03233227476182,0.3892542488726629,2591,11621,fhi:git
county,Møre og Romsdal,2020-12-27,0,0,0,0,0.0,0.0,0,0,fhi:git
county,Møre og Romsdal,2020-12-28,0,0,0,0,0.0,0.0,0,0,fhi:git
county,Møre og Romsdal,2020-12-29,0,0,0,0,0.0,0.0,0,0,fhi:git
county,Møre og Romsdal,2020-12-30,0,0,0,0,0.0,0.0,0,0,fhi:git
county,Møre og Romsdal,2020-12-31,0,0,0,0,0.0,0.0,0,0,fhi:git
county,Møre og Romsdal,2021-01-01,0,0,0,0,0.0,0.0,0,0,fhi:git
county,Møre og Romsdal,2021-01-02,0,0,0,0,0.0,0.0,0,0,fhi:git
county,Møre og Romsdal,2021-01-03,0,0,0,0,0.0,0.0,0,0,fhi:git
county,Møre og Romsdal,2021-01-04,0,0,0,0,0.0,0.0,0,0,fhi:git
county,Møre og Romsdal,2021-01-05,186,0,186,0,0.0701256984293352,0.0,186,186,fhi:git
county,Møre og Romsdal,2021-01-06,497,0,683,0,0.257504580791591,0.0,497,683,fhi:git
county,Møre og Romsdal,2021-01-07,457,0,1140,0,0.429802667792699,0.0,457,1140,fhi:git
county,Møre og Romsdal,2021-01-08,35,0,1175,0,0.442998363733703,0.0,35,1175,fhi:git
county,Møre og Romsdal,2021-01-09,0,0,1175,0,0.442998363733703,0.0,0,1175,fhi:git
county,Møre og Romsdal,2021-01-10,0,0,1175,0,0.442998363733703,0.0,0,1175,fhi:git
county,Møre og Romsdal,2021-01-11,0,0,1175,0,0.442998363733703,0.0,0,1175,fhi:git
county,Møre og Romsdal,2021-01-12,227,0,1402,0,0.528581877408215,0.0,227,1402,fhi:git
county,Møre og Romsdal,2021-01-13,387,0,1789,0,0.6744885725273149,0.0,387,1789,fhi:git
county,Møre og Romsdal,2021-01-14,404,0,2193,0,0.826804605674903,0.0,404,2193,fhi:git
county,Møre og Romsdal,2021-01-15,152,0,2345,0,0.8841116280472628,0.0,152,2345,fhi:git
county,Møre og Romsdal,2021-01-16,1,0,2346,0,0.884488647931292,0.0,1,2346,fhi:git
county,Møre og Romsdal,2021-01-17,1,0,2347,0,0.8848656678153209,0.0,1,2347,fhi:git
county,Møre og Romsdal,2021-01-18,11,0,2358,0,0.889012886539636,0.0,11,2358,fhi:git
county,Møre og Romsdal,2021-01-19,163,0,2521,0,0.9504671276363119,0.0,163,2521,fhi:git
county,Møre og Romsdal,2021-01-20,488,0,3009,0,1.13445283104231,0.0,488,3009,fhi:git
county,Møre og Romsdal,2021-01-21,756,0,3765,0,1.41947986336799,0.0,756,3765,fhi:git
county,Møre og Romsdal,2021-01-22,210,0,3975,0,1.49865403901402,0.0,210,3975,fhi:git
county,Møre og Romsdal,2021-01-23,0,0,3975,0,1.49865403901402,0.0,0,3975,fhi:git
county,Møre og Romsdal,2021-01-24,0,0,3975,0,1.49865403901402,0.0,0,3975,fhi:git
county,Møre og Romsdal,2021-01-25,3,0,3978,0,1.4997850986661,0.0,3,3978,fhi:git
county,Møre og Romsdal,2021-01-26,73,127,4051,127,1.5273075502002,0.0478815252716428,200,4178,fhi:git
county,Møre og Romsdal,2021-01-27,517,348,4568,475,1.72222683024303,0.17908444491362502,865,5043,fhi:git
county,Møre og Romsdal,2021-01-28,462,447,5030,922,1.89641001666428,0.347612333074446,909,5952,fhi:git
county,Møre og Romsdal,2021-01-29,78,66,5108,988,1.9258175676185199,0.37249564542033897,144,6096,fhi:git
county,Møre og Romsdal,2021-01-30,0,0,5108,988,1.9258175676185199,0.37249564542033897,0,6096,fhi:git
county,Møre og Romsdal,2021-01-31,0,0,5108,988,1.9258175676185199,0.37249564542033897,0,6096,fhi:git
county,Møre og Romsdal,2021-02-01,0,0,5108,988,1.9258175676185199,0.37249564542033897,0,6096,fhi:git
county,Møre og Romsdal,2021-02-02,256,194,5364,1182,2.0223346579298602,0.445637502921904,450,6546,fhi:git
county,Møre og Romsdal,2021-02-03,897,240,6261,1422,2.36052149390359,0.536122275088788,1137,7683,fhi:git
county,Nordland,2020-12-27,0,0,0,0,0.0,0.0,0,0,fhi:git
county,Nordland,2020-12-28,0,0,0,0,0.0,0.0,0,0,fhi:git
county,Nordland,2020-12-29,0,0,0,0,0.0,0.0,0,0,fhi:git
county,Nordland,2020-12-30,0,0,0,0,0.0,0.0,0,0,fhi:git
county,Nordland,2020-12-31,0,0,0,0,0.0,0.0,0,0,fhi:git
county,Nordland,2021-01-01,0,0,0,0,0.0,0.0,0,0,fhi:git
county,Nordland,2021-01-02,0,0,0,0,0.0,0.0,0,0,fhi:git
county,Nordland,2021-01-03,0,0,0,0,0.0,0.0,0,0,fhi:git
county,Nordland,2021-01-04,0,0,0,0,0.0,0.0,0,0,fhi:git
county,Nordland,2021-01-05,200,0,200,0,0.0829067092254441,0.0,200,200,fhi:git
county,Nordland,2021-01-06,687,0,887,0,0.367691255414845,0.0,687,887,fhi:git
county,Nordland,2021-01-07,238,0,1125,0,0.46635023939312303,0.0,238,1125,fhi:git
county,Nordland,2021-01-08,115,0,1240,0,0.514021597197753,0.0,115,1240,fhi:git
county,Nordland,2021-01-09,0,0,1240,0,0.514021597197753,0.0,0,1240,fhi:git
county,Nordland,2021-01-10,0,0,1240,0,0.514021597197753,0.0,0,1240,fhi:git
county,Nordland,2021-01-11,0,0,1240,0,0.514021597197753,0.0,0,1240,fhi:git
county,Nordland,2021-01-12,291,0,1531,0,0.6346508591207739,0.0,291,1531,fhi:git
county,Nordland,2021-01-13,602,0,2133,0,0.8842000538893611,0.0,602,2133,fhi:git
county,Nordland,2021-01-14,274,0,2407,0,0.997782245528219,0.0,274,2407,fhi:git
county,Nordland,2021-01-15,69,0,2476,0,1.026385060211,0.0,69,2476,fhi:git
county,Nordland,2021-01-16,0,0,2476,0,1.026385060211,0.0,0,2476,fhi:git
county,Nordland,2021-01-17,0,0,2476,0,1.026385060211,0.0,0,2476,fhi:git
county,Nordland,2021-01-18,0,0,2476,0,1.026385060211,0.0,0,2476,fhi:git
county,Nordland,2021-01-19,313,0,2789,0,1.1561340601488201,0.0,313,2789,fhi:git
county,Nordland,2021-01-20,785,0,3574,0,1.4815428938586899,0.0,785,3574,fhi:git
county,Nordland,2021-01-21,613,0,4187,0,1.7356519576346698,0.0,613,4187,fhi:git
county,Nordland,2021-01-22,167,0,4354,0,1.80487905983792,0.0,167,4354,fhi:git
county,Nordland,2021-01-23,1,0,4355,0,1.80529359338404,0.0,1,4355,fhi:git
county,Nordland,2021-01-24,0,0,4355,0,1.80529359338404,0.0,0,4355,fhi:git
county,Nordland,2021-01-25,51,0,4406,0,1.8264348042365302,0.0,51,4406,fhi:git
county,Nordland,2021-01-26,95,90,4501,90,1.86581549111862,0.0373080191514498,185,4591,fhi:git
county,Nordland,2021-01-27,622,529,5123,619,2.12365535680975,0.256596265052749,1151,5742,fhi:git
county,Nordland,2021-01-28,467,364,5590,983,2.31724252285116,0.407486475843058,831,6573,fhi:git
county,Nordland,2021-01-29,207,96,5797,1079,2.4030509668995,0.44728169627127096,303,6876,fhi:git
county,Nordland,2021-01-30,0,0,5797,1079,2.4030509668995,0.44728169627127096,0,6876,fhi:git
county,Nordland,2021-01-31,0,0,5797,1079,2.4030509668995,0.44728169627127096,0,6876,fhi:git
county,Nordland,2021-02-01,9,4,5806,1083,2.40678176881464,0.44893983045578,13,6889,fhi:git
county,Nordland,2021-02-02,97,198,5903,1281,2.44699152278898,0.531017472588969,295,7184,fhi:git
county,Nordland,2021-02-03,1037,355,6940,1636,2.87686281012291,0.678176881464133,1392,8576,fhi:git
county,Viken,2020-12-27,0,0,0,0,0.0,0.0,0,0,fhi:git
county,Viken,2020-12-28,64,0,64,0,0.0051564457586219395,0.0,64,64,fhi:git
county,Viken,2020-12-29,690,0,754,0,0.0607493765937647,0.0,690,754,fhi:git
county,Viken,2020-12-30,216,0,970,0,0.0781523810291138,0.0,216,970,fhi:git
county,Viken,2020-12-31,67,0,1037,0,0.0835505351826711,0.0,67,1037,fhi:git
county,Viken,2021-01-01,0,0,1037,0,0.0835505351826711,0.0,0,1037,fhi:git
county,Viken,2021-01-02,0,0,1037,0,0.0835505351826711,0.0,0,1037,fhi:git
county,Viken,2021-01-03,0,0,1037,0,0.0835505351826711,0.0,0,1037,fhi:git
county,Viken,2021-01-04,0,0,1037,0,0.0835505351826711,0.0,0,1037,fhi:git
county,Viken,2021-01-05,524,0,1561,0,0.12576893483138799,0.0,524,1561,fhi:git
county,Viken,2021-01-06,1651,0,3212,0,0.258789121510839,0.0,1651,3212,fhi:git
county,Viken,2021-01-07,1911,0,5123,0,0.412757369084691,0.0,1911,5123,fhi:git
county,Viken,2021-01-08,279,0,5402,0,0.435236249813683,0.0,279,5402,fhi:git
county,Viken,2021-01-09,6,0,5408,0,0.435719666603554,0.0,6,5408,fhi:git
county,Viken,2021-01-10,5,0,5413,0,0.43612251392844603,0.0,5,5413,fhi:git
county,Viken,2021-01-11,55,0,5468,0,0.44055383450226204,0.0,55,5468,fhi:git
county,Viken,2021-01-12,769,0,6237,0,0.502511753070704,0.0,769,6237,fhi:git
county,Viken,2021-01-13,1932,0,8169,0,0.658171959409104,0.0,1932,8169,fhi:git
county,Viken,2021-01-14,1945,0,10114,0,0.8148795687922241,0.0,1945,10114,fhi:git
county,Viken,2021-01-15,1039,0,11153,0,0.898591242904851,0.0,1039,11153,fhi:git
county,Viken,2021-01-16,85,0,11238,0,0.905439647428021,0.0,85,11238,fhi:git
county,Viken,2021-01-17,22,0,11260,0,0.907212175657548,0.0,22,11260,fhi:git
county,Viken,2021-01-18,141,51,11401,51,0.9185724702195122,0.00410904271390186,192,11452,fhi:git
county,Viken,2021-01-19,640,380,12041,431,0.970136927805731,0.0347254394057196,1020,12472,fhi:git
county,Viken,2021-01-20,1467,341,13508,772,1.0883323329291401,0.0621996269633771,1808,14280,fhi:git
county,Viken,2021-01-21,1965,99,15473,871,1.2466513316118302,0.0701760039962455,2064,16344,fhi:git
county,Viken,2021-01-22,802,1,16275,872,1.3112680425245602,0.0702565734612239,803,17147,fhi:git
county,Viken,2021-01-23,97,0,16372,872,1.31908328062748,0.0702565734612239,97,17244,fhi:git
county,Viken,2021-01-24,0,0,16372,872,1.31908328062748,0.0702565734612239,0,17244,fhi:git
county,Viken,2021-01-25,59,0,16431,872,1.3238368790612,0.0702565734612239,59,17303,fhi:git
county,Viken,2021-01-26,546,389,16977,1261,1.3678278069394498,0.10159809533784801,935,18238,fhi:git
county,Viken,2021-01-27,1881,1143,18858,2404,1.51937897056395,0.193688993808237,3024,21262,fhi:git
county,Viken,2021-01-28,3079,1622,21937,4026,1.7674523532326498,0.32437266600331105,4701,25963,fhi:git
county,Viken,2021-01-29,1026,416,22963,4442,1.85011662430056,0.357889563434354,1442,27405,fhi:git
county,Viken,2021-01-30,4,17,22967,4459,1.85043890216047,0.359259244338988,21,27426,fhi:git
county,Viken,2021-01-31,0,3,22967,4462,1.85043890216047,0.35950095273392296,3,27429,fhi:git
county,Viken,2021-02-01,13,45,22980,4507,1.85148630520519,0.36312657865795395,58,27487,fhi:git
county,Viken,2021-02-02,905,615,23885,5122,1.9244016710107,0.412676799619712,1520,29007,fhi:git
county,Viken,2021-02-03,4226,1335,28111,6457,2.26488823000971,0.520237035365967,5561,34568,fhi:git
county,Innlandet,2020-12-27,0,0,0,0,0.0,0.0,0,0,fhi:git
county,Innlandet,2020-12-28,271,0,271,0,0.07297009841539098,0.0,271,271,fhi:git
county,Innlandet,2020-12-29,260,0,531,0,0.142978310917242,0.0,260,531,fhi:git
county,Innlandet,2020-12-30,149,0,680,0,0.18309840192791801,0.0,149,680,fhi:git
county,Innlandet,2020-12-31,0,0,680,0,0.18309840192791801,0.0,0,680,fhi:git
county,Innlandet,2021-01-01,0,0,680,0,0.18309840192791801,0.0,0,680,fhi:git
county,Innlandet,2021-01-02,0,0,680,0,0.18309840192791801,0.0,0,680,fhi:git
county,Innlandet,2021-01-03,0,0,680,0,0.18309840192791801,0.0,0,680,fhi:git
county,Innlandet,2021-01-04,0,0,680,0,0.18309840192791801,0.0,0,680,fhi:git
county,Innlandet,2021-01-05,320,0,1000,0,0.269262355776351,0.0,320,1000,fhi:git
county,Innlandet,2021-01-06,651,0,1651,0,0.444552149386755,0.0,651,1651,fhi:git
county,Innlandet,2021-01-07,711,0,2362,0,0.6359976843437399,0.0,711,2362,fhi:git
county,Innlandet,2021-01-08,76,0,2438,0,0.6564616233827429,0.0,76,2438,fhi:git
county,Innlandet,2021-01-09,0,0,2438,0,0.6564616233827429,0.0,0,2438,fhi:git
county,Innlandet,2021-01-10,0,0,2438,0,0.6564616233827429,0.0,0,2438,fhi:git
county,Innlandet,2021-01-11,51,0,2489,0,0.670194003527337,0.0,51,2489,fhi:git
county,Innlandet,2021-01-12,442,0,2931,0,0.7892079647804839,0.0,442,2931,fhi:git
county,Innlandet,2021-01-13,952,0,3883,0,1.0455457274795699,0.0,952,3883,fhi:git
county,Innlandet,2021-01-14,940,0,4823,0,1.29865234190934,0.0,940,4823,fhi:git
county,Innlandet,2021-01-15,271,0,5094,0,1.37162244032473,0.0,271,5094,fhi:git
county,Innlandet,2021-01-16,4,0,5098,0,1.3726994897478402,0.0,4,5098,fhi:git
county,Innlandet,2021-01-17,0,0,5098,0,1.3726994897478402,0.0,0,5098,fhi:git
county,Innlandet,2021-01-18,67,0,5165,0,1.3907400675848502,0.0,67,5165,fhi:git
county,Innlandet,2021-01-19,331,318,5496,318,1.4798659073468199,0.0856254291368795,649,5814,fhi:git
county,Innlandet,2021-01-20,658,252,6154,570,1.65704053744766,0.15347954279252,910,6724,fhi:git
county,Innlandet,2021-01-21,826,48,6980,618,1.8794512433189299,0.166404135869785,874,7598,fhi:git
county,Innlandet,2021-01-22,220,0,7200,618,1.93868896158973,0.166404135869785,220,7818,fhi:git
county,Innlandet,2021-01-23,5,0,7205,618,1.9400352733686101,0.166404135869785,5,7823,fhi:git
county,Innlandet,2021-01-24,0,0,7205,618,1.9400352733686101,0.166404135869785,0,7823,fhi:git
county,Innlandet,2021-01-25,2,0,7207,618,1.94057379808016,0.166404135869785,2,7825,fhi:git
county,Innlandet,2021-01-26,141,130,7348,748,1.97853979024463,0.20140824212070998,271,8096,fhi:git
county,Innlandet,2021-01-27,899,547,8247,1295,2.22060664808756,0.3486947507303739,1446,9542,fhi:git
county,Innlandet,2021-01-28,849,699,9096,1994,2.44921038814169,0.5369091374180429,1548,11090,fhi:git
county,Innlandet,2021-01-29,298,132,9394,2126,2.52945057016304,0.572451768380522,430,11520,fhi:git
county,Innlandet,2021-01-30,1,0,9395,2126,2.5297198325188197,0.572451768380522,1,11521,fhi:git
county,Innlandet,2021-01-31,0,0,9395,2126,2.5297198325188197,0.572451768380522,0,11521,fhi:git
county,Innlandet,2021-02-01,8,49,9403,2175,2.53187393136503,0.585645623813563,57,11578,fhi:git
county,Innlandet,2021-02-02,587,330,9990,2505,2.6899309342057403,0.674502201219759,917,12495,fhi:git
county,Innlandet,2021-02-03,2214,670,12204,3175,3.28607778989458,0.8549079795899129,2884,15379,fhi:git
county,Vestfold og Telemark,2020-12-27,0,0,0,0,0.0,0.0,0,0,fhi:git
county,Vestfold og Telemark,2020-12-28,0,0,0,0,0.0,0.0,0,0,fhi:git
county,Vestfold og Telemark,2020-12-29,0,0,0,0,0.0,0.0,0,0,fhi:git
county,Vestfold og Telemark,2020-12-30,0,0,0,0,0.0,0.0,0,0,fhi:git
county,Vestfold og Telemark,2020-12-31,0,0,0,0,0.0,0.0,0,0,fhi:git
county,Vestfold og Telemark,2021-01-01,0,0,0,0,0.0,0.0,0,0,fhi:git
county,Vestfold og Telemark,2021-01-02,0,0,0,0,0.0,0.0,0,0,fhi:git
county,Vestfold og Telemark,2021-01-03,0,0,0,0,0.0,0.0,0,0,fhi:git
county,Vestfold og Telemark,2021-01-04,0,0,0,0,0.0,0.0,0,0,fhi:git
county,Vestfold og Telemark,2021-01-05,218,0,218,0,0.0519795133954544,0.0,218,218,fhi:git
county,Vestfold og Telemark,2021-01-06,1025,0,1243,0,0.296378601608027,0.0,1025,1243,fhi:git
county,Vestfold og Telemark,2021-01-07,442,0,1685,0,0.401768257207985,0.0,442,1685,fhi:git
county,Vestfold og Telemark,2021-01-08,64,0,1749,0,0.41702829783784295,0.0,64,1749,fhi:git
county,Vestfold og Telemark,2021-01-09,0,0,1749,0,0.41702829783784295,0.0,0,1749,fhi:git
county,Vestfold og Telemark,2021-01-10,2,0,1751,0,0.417505174107526,0.0,2,1751,fhi:git
county,Vestfold og Telemark,2021-01-11,2,0,1753,0,0.417982050377209,0.0,2,1753,fhi:git
county,Vestfold og Telemark,2021-01-12,419,0,2172,0,0.517887628875812,0.0,419,2172,fhi:git
county,Vestfold og Telemark,2021-01-13,1154,0,3326,0,0.793045236482942,0.0,1154,3326,fhi:git
county,Vestfold og Telemark,2021-01-14,585,0,3911,0,0.93253154536524,0.0,585,3911,fhi:git
county,Vestfold og Telemark,2021-01-15,157,0,4068,0,0.96996633253536,0.0,157,4068,fhi:git
county,Vestfold og Telemark,2021-01-16,3,0,4071,0,0.970681646939885,0.0,3,4071,fhi:git
county,Vestfold og Telemark,2021-01-17,39,0,4110,0,0.9799807341987049,0.0,39,4110,fhi:git
county,Vestfold og Telemark,2021-01-18,5,0,4115,0,0.981172924872912,0.0,5,4115,fhi:git
county,Vestfold og Telemark,2021-01-19,226,0,4341,0,1.0350599433471,0.0,226,4341,fhi:git
county,Vestfold og Telemark,2021-01-20,1602,0,5943,0,1.41703783536324,0.0,1602,5943,fhi:git
county,Vestfold og Telemark,2021-01-21,816,0,6759,0,1.6116033533939298,0.0,816,6759,fhi:git
county,Vestfold og Telemark,2021-01-22,178,0,6937,0,1.65404534139572,0.0,178,6937,fhi:git
county,Vestfold og Telemark,2021-01-23,3,0,6940,0,1.65476065580025,0.0,3,6940,fhi:git
county,Vestfold og Telemark,2021-01-24,0,0,6940,0,1.65476065580025,0.0,0,6940,fhi:git
county,Vestfold og Telemark,2021-01-25,45,0,6985,0,1.6654903718681202,0.0,45,6985,fhi:git
county,Vestfold og Telemark,2021-01-26,96,177,7081,177,1.6883804328129,0.0422035498669515,273,7258,fhi:git
county,Vestfold og Telemark,2021-01-27,1618,897,8699,1074,2.0741733349865004,0.256082556819808,2515,9773,fhi:git
county,Vestfold og Telemark,2021-01-28,651,449,9350,1523,2.22939656076834,0.363141279363656,1100,10873,fhi:git
county,Vestfold og Telemark,2021-01-29,86,90,9436,1613,2.24990224036472,0.38460071149939395,176,11049,fhi:git
county,Vestfold og Telemark,2021-01-30,0,0,9436,1613,2.24990224036472,0.38460071149939395,0,11049,fhi:git
county,Vestfold og Telemark,2021-01-31,0,1,9436,1614,2.24990224036472,0.38483914963423604,1,11050,fhi:git
county,Vestfold og Telemark,2021-02-01,49,0,9485,1614,2.26158570897195,0.38483914963423604,49,11099,fhi:git
county,Vestfold og Telemark,2021-02-02,456,324,9941,1938,2.37031349845969,0.46209310532289294,780,11879,fhi:git
county,Vestfold og Telemark,2021-02-03,3076,763,13017,2701,3.1037492012322496,0.6440214022069829,3839,15718,fhi:git
county,Agder,2020-12-27,0,0,0,0,0.0,0.0,0,0,fhi:git
county,Agder,2020-12-28,0,0,0,0,0.0,0.0,0,0,fhi:git
county,Agder,2020-12-29,0,0,0,0,0.0,0.0,0,0,fhi:git
county,Agder,2020-12-30,0,0,0,0,0.0,0.0,0,0,fhi:git
county,Agder,2020-12-31,0,0,0,0,0.0,0.0,0,0,fhi:git
county,Agder,2021-01-01,0,0,0,0,0.0,0.0,0,0,fhi:git
county,Agder,2021-01-02,0,0,0,0,0.0,0.0,0,0,fhi:git
county,Agder,2021-01-03,0,0,0,0,0.0,0.0,0,0,fhi:git
county,Agder,2021-01-04,0,0,0,0,0.0,0.0,0,0,fhi:git
county,Agder,2021-01-05,79,0,79,0,0.0257135510413988,0.0,79,79,fhi:git
county,Agder,2021-01-06,791,0,870,0,0.283174549443253,0.0,791,870,fhi:git
county,Agder,2021-01-07,230,0,1100,0,0.35803678665238897,0.0,230,1100,fhi:git
county,Agder,2021-01-08,49,0,1149,0,0.37398569805781295,0.0,49,1149,fhi:git
county,Agder,2021-01-09,0,0,1149,0,0.37398569805781295,0.0,0,1149,fhi:git
county,Agder,2021-01-10,0,0,1149,0,0.37398569805781295,0.0,0,1149,fhi:git
county,Agder,2021-01-11,0,0,1149,0,0.37398569805781295,0.0,0,1149,fhi:git
county,Agder,2021-01-12,225,0,1374,0,0.44722049532762,0.0,225,1374,fhi:git
county,Agder,2021-01-13,851,0,2225,0,0.724210773001422,0.0,851,2225,fhi:git
county,Agder,2021-01-14,500,0,2725,0,0.886954766934326,0.0,500,2725,fhi:git
county,Agder,2021-01-15,118,0,2843,0,0.9253623495024921,0.0,118,2843,fhi:git
county,Agder,2021-01-16,0,0,2843,0,0.9253623495024921,0.0,0,2843,fhi:git
county,Agder,2021-01-17,2,0,2845,0,0.926013325478223,0.0,2,2845,fhi:git
county,Agder,2021-01-18,15,0,2860,0,0.9308956452962099,0.0,15,2860,fhi:git
county,Agder,2021-01-19,348,0,3208,0,1.04416546507351,0.0,348,3208,fhi:git
county,Agder,2021-01-20,452,0,3660,0,1.1912860355888601,0.0,452,3660,fhi:git
county,Agder,2021-01-21,335,0,3995,0,1.3003245115239,0.0,335,3995,fhi:git
county,Agder,2021-01-22,56,0,4051,0,1.31855183884439,0.0,56,4051,fhi:git
county,Agder,2021-01-23,1,0,4052,0,1.31887732683225,0.0,1,4052,fhi:git
county,Agder,2021-01-24,0,0,4052,0,1.31887732683225,0.0,0,4052,fhi:git
county,Agder,2021-01-25,1,0,4053,0,1.3192028148201203,0.0,1,4053,fhi:git
county,Agder,2021-01-26,62,66,4115,66,1.3393830700678,0.0214822071991433,128,4181,fhi:git
county,Agder,2021-01-27,535,674,4650,740,1.5135191435760098,0.240861111020698,1209,5390,fhi:git
county,Agder,2021-01-28,909,248,5559,988,1.8093877245460301,0.32158213201141805,1157,6547,fhi:git
county,Agder,2021-01-29,184,61,5743,1049,1.86927751431333,0.34143689927123194,245,6792,fhi:git
county,Agder,2021-01-30,29,0,5772,1049,1.8787166659614398,0.34143689927123194,29,6821,fhi:git
county,Agder,2021-01-31,20,0,5792,1049,1.8852264257187599,0.34143689927123194,20,6841,fhi:git
county,Agder,2021-02-01,0,1,5792,1050,1.8852264257187599,0.34176238725909797,1,6842,fhi:git
county,Agder,2021-02-02,201,157,5993,1207,1.9506495112797901,0.39286400135403,358,7200,fhi:git
county,Agder,2021-02-03,1192,466,7185,1673,2.3386311928158303,0.544541403699497,1658,8858,fhi:git
county,Vestland,2020-12-27,0,0,0,0,0.0,0.0,0,0,fhi:git
county,Vestland,2020-12-28,0,0,0,0,0.0,0.0,0,0,fhi:git
county,Vestland,2020-12-29,0,0,0,0,0.0,0.0,0,0,fhi:git
county,Vestland,2020-12-30,0,0,0,0,0.0,0.0,0,0,fhi:git
county,Vestland,2020-12-31,0,0,0,0,0.0,0.0,0,0,fhi:git
county,Vestland,2021-01-01,0,0,0,0,0.0,0.0,0,0,fhi:git
county,Vestland,2021-01-02,0,0,0,0,0.0,0.0,0,0,fhi:git
county,Vestland,2021-01-03,0,0,0,0,0.0,0.0,0,0,fhi:git
county,Vestland,2021-01-04,1,0,1,0,0.00015710153943798502,0.0,1,1,fhi:git
county,Vestland,2021-01-05,416,0,417,0,0.0655113419456397,0.0,416,417,fhi:git
county,Vestland,2021-01-06,1250,0,1667,0,0.261888266243121,0.0,1250,1667,fhi:git
county,Vestland,2021-01-07,715,0,2382,0,0.37421586694128,0.0,715,2382,fhi:git
county,Vestland,2021-01-08,139,0,2521,0,0.39605298092315994,0.0,139,2521,fhi:git
county,Vestland,2021-01-09,0,0,2521,0,0.39605298092315994,0.0,0,2521,fhi:git
county,Vestland,2021-01-10,0,0,2521,0,0.39605298092315994,0.0,0,2521,fhi:git
county,Vestland,2021-01-11,60,0,2581,0,0.40547907328943894,0.0,60,2581,fhi:git
county,Vestland,2021-01-12,854,0,3435,0,0.539643787969478,0.0,854,3435,fhi:git
county,Vestland,2021-01-13,1123,0,4558,0,0.716068816758336,0.0,1123,4558,fhi:git
county,Vestland,2021-01-14,990,0,5548,0,0.87159934080194,0.0,990,5548,fhi:git
county,Vestland,2021-01-15,422,0,5970,0,0.93789619044477,0.0,422,5970,fhi:git
county,Vestland,2021-01-16,2,0,5972,0,0.938210393523646,0.0,2,5972,fhi:git
county,Vestland,2021-01-17,1,0,5973,0,0.938367495063084,0.0,1,5973,fhi:git
county,Vestland,2021-01-18,54,0,6027,0,0.946850978192735,0.0,54,6027,fhi:git
county,Vestland,2021-01-19,368,0,6395,0,1.00466434470591,0.0,368,6395,fhi:git
county,Vestland,2021-01-20,1233,0,7628,0,1.1983705428329499,0.0,1233,7628,fhi:git
county,Vestland,2021-01-21,777,0,8405,0,1.32043843897626,0.0,777,8405,fhi:git
county,Vestland,2021-01-22,304,0,8709,0,1.3681973069654099,0.0,304,8709,fhi:git
county,Vestland,2021-01-23,0,0,8709,0,1.3681973069654099,0.0,0,8709,fhi:git
county,Vestland,2021-01-24,0,0,8709,0,1.3681973069654099,0.0,0,8709,fhi:git
county,Vestland,2021-01-25,1,0,8710,0,1.36835440850485,0.0,1,8710,fhi:git
county,Vestland,2021-01-26,150,103,8860,103,1.3919196394205502,0.0161814585621125,253,8963,fhi:git
county,Vestland,2021-01-27,1558,1172,10418,1275,1.63668383786493,0.20030446278343103,2730,11693,fhi:git
county,Vestland,2021-01-28,1906,635,12324,1910,1.9361193720337297,0.30006394032655104,2541,14234,fhi:git
county,Vestland,2021-01-29,465,164,12789,2074,2.0091715878723897,0.32582859279438103,629,14863,fhi:git
county,Vestland,2021-01-30,0,0,12789,2074,2.0091715878723897,0.32582859279438103,0,14863,fhi:git
county,Vestland,2021-01-31,0,0,12789,2074,2.0091715878723897,0.32582859279438103,0,14863,fhi:git
county,Vestland,2021-02-01,13,58,12802,2132,2.01121390788508,0.334940482081784,71,14934,fhi:git
county,Vestland,2021-02-02,645,577,13447,2709,2.11254440082258,0.425588070337501,1222,16156,fhi:git
county,Vestland,2021-02-03,2447,974,15894,3683,2.49697186782733,0.578604969750099,3421,19577,fhi:git
county,Trøndelag,2020-12-27,0,0,0,0,0.0,0.0,0,0,fhi:git
county,Trøndelag,2020-12-28,0,0,0,0,0.0,0.0,0,0,fhi:git
county,Trøndelag,2020-12-29,0,0,0,0,0.0,0.0,0,0,fhi:git
county,Trøndelag,2020-12-30,0,0,0,0,0.0,0.0,0,0,fhi:git
county,Trøndelag,2020-12-31,0,0,0,0,0.0,0.0,0,0,fhi:git
county,Trøndelag,2021-01-01,0,0,0,0,0.0,0.0,0,0,fhi:git
county,Trøndelag,2021-01-02,0,0,0,0,0.0,0.0,0,0,fhi:git
county,Trøndelag,2021-01-03,0,0,0,0,0.0,0.0,0,0,fhi:git
county,Trøndelag,2021-01-04,0,0,0,0,0.0,0.0,0,0,fhi:git
county,Trøndelag,2021-01-05,411,0,411,0,0.0876889793514856,0.0,411,411,fhi:git
county,Trøndelag,2021-01-06,674,0,1085,0,0.231490371280686,0.0,674,1085,fhi:git
county,Trøndelag,2021-01-07,482,0,1567,0,0.334327568476345,0.0,482,1567,fhi:git
county,Trøndelag,2021-01-08,140,0,1707,0,0.364197293802885,0.0,140,1707,fhi:git
county,Trøndelag,2021-01-09,0,0,1707,0,0.364197293802885,0.0,0,1707,fhi:git
county,Trøndelag,2021-01-10,0,0,1707,0,0.364197293802885,0.0,0,1707,fhi:git
county,Trøndelag,2021-01-11,95,0,1802,0,0.384466035988752,0.0,95,1802,fhi:git
county,Trøndelag,2021-01-12,500,0,2302,0,0.491143626440681,0.0,500,2302,fhi:git
county,Trøndelag,2021-01-13,863,0,3165,0,0.67526914756071,0.0,863,3165,fhi:git
county,Trøndelag,2021-01-14,666,0,3831,0,0.81736369804268,0.0,666,3831,fhi:git
county,Trøndelag,2021-01-15,253,0,4084,0,0.871342558811356,0.0,253,4084,fhi:git
county,Trøndelag,2021-01-16,0,0,4084,0,0.871342558811356,0.0,0,4084,fhi:git
county,Trøndelag,2021-01-17,0,0,4084,0,0.871342558811356,0.0,0,4084,fhi:git
county,Trøndelag,2021-01-18,155,0,4239,0,0.904412611851454,0.0,155,4239,fhi:git
county,Trøndelag,2021-01-19,568,0,4807,0,1.02559835460484,0.0,568,4807,fhi:git
county,Trøndelag,2021-01-20,733,0,5540,0,1.1819877022073702,0.0,733,5540,fhi:git
county,Trøndelag,2021-01-21,495,0,6035,0,1.2875985167547799,0.0,495,6035,fhi:git
county,Trøndelag,2021-01-22,284,0,6319,0,1.34819138813148,0.0,284,6319,fhi:git
county,Trøndelag,2021-01-23,1,0,6320,0,1.34840474331238,0.0,1,6320,fhi:git
county,Trøndelag,2021-01-24,0,0,6320,0,1.34840474331238,0.0,0,6320,fhi:git
county,Trøndelag,2021-01-25,1,0,6321,0,1.3486180984932898,0.0,1,6321,fhi:git
county,Trøndelag,2021-01-26,314,184,6635,184,1.4156116252971003,0.0392573532863098,498,6819,fhi:git
county,Trøndelag,2021-01-27,963,592,7598,776,1.62107266450751,0.16556362038139402,1555,8374,fhi:git
county,Trøndelag,2021-01-28,699,467,8297,1243,1.77020793595931,0.265200489863495,1166,9540,fhi:git
county,Trøndelag,2021-01-29,383,197,8680,1440,1.85192297024549,0.307231460501555,580,10120,fhi:git
county,Trøndelag,2021-01-30,0,0,8680,1440,1.85192297024549,0.307231460501555,0,10120,fhi:git
county,Trøndelag,2021-01-31,0,1,8680,1441,1.85192297024549,0.307444815682459,1,10121,fhi:git
county,Trøndelag,2021-02-01,3,86,8683,1527,1.8525630357882,0.32579336124019104,89,10210,fhi:git
county,Trøndelag,2021-02-02,821,391,9504,1918,2.02772763931027,0.40921523697359896,1212,11422,fhi:git
county,Trøndelag,2021-02-03,1688,727,11192,2645,2.38787118467598,0.564324453490704,2415,13837,fhi:git
county,Troms og Finnmark,2020-12-27,0,0,0,0,0.0,0.0,0,0,fhi:git
county,Troms og Finnmark,2020-12-28,1,0,1,0,0.00041099662571770297,0.0,1,1,fhi:git
county,Troms og Finnmark,2020-12-29,0,0,1,0,0.00041099662571770297,0.0,0,1,fhi:git
county,Troms og Finnmark,2020-12-30,0,0,1,0,0.00041099662571770297,0.0,0,1,fhi:git
county,Troms og Finnmark,2020-12-31,0,0,1,0,0.00041099662571770297,0.0,0,1,fhi:git
county,Troms og Finnmark,2021-01-01,0,0,1,0,0.00041099662571770297,0.0,0,1,fhi:git
county,Troms og Finnmark,2021-01-02,0,0,1,0,0.00041099662571770297,0.0,0,1,fhi:git
county,Troms og Finnmark,2021-01-03,0,0,1,0,0.00041099662571770297,0.0,0,1,fhi:git
county,Troms og Finnmark,2021-01-04,0,0,1,0,0.00041099662571770297,0.0,0,1,fhi:git
county,Troms og Finnmark,2021-01-05,53,0,54,0,0.022193817788756,0.0,53,54,fhi:git
county,Troms og Finnmark,2021-01-06,529,0,583,0,0.23961103279342102,0.0,529,583,fhi:git
county,Troms og Finnmark,2021-01-07,188,0,771,0,0.31687839842834903,0.0,188,771,fhi:git
county,Troms og Finnmark,2021-01-08,247,0,1018,0,0.418394564980622,0.0,247,1018,fhi:git
county,Troms og Finnmark,2021-01-09,0,0,1018,0,0.418394564980622,0.0,0,1018,fhi:git
county,Troms og Finnmark,2021-01-10,0,0,1018,0,0.418394564980622,0.0,0,1018,fhi:git
county,Troms og Finnmark,2021-01-11,1,0,1019,0,0.41880556160633897,0.0,1,1019,fhi:git
county,Troms og Finnmark,2021-01-12,188,0,1207,0,0.49607292724126706,0.0,188,1207,fhi:git
county,Troms og Finnmark,2021-01-13,568,0,1775,0,0.7295190106489229,0.0,568,1775,fhi:git
county,Troms og Finnmark,2021-01-14,329,0,2104,0,0.8647369005100469,0.0,329,2104,fhi:git
county,Troms og Finnmark,2021-01-15,37,0,2141,0,0.879943775661602,0.0,37,2141,fhi:git
county,Troms og Finnmark,2021-01-16,2,0,2143,0,0.880765768913037,0.0,2,2143,fhi:git
county,Troms og Finnmark,2021-01-17,1,0,2144,0,0.881176765538755,0.0,1,2144,fhi:git
county,Troms og Finnmark,2021-01-18,0,1,2144,1,0.881176765538755,0.00041099662571770297,1,2145,fhi:git
county,Troms og Finnmark,2021-01-19,248,0,2392,1,0.9831039287167449,0.00041099662571770297,248,2393,fhi:git
county,Troms og Finnmark,2021-01-20,909,0,3301,1,1.3566998614941401,0.00041099662571770297,909,3302,fhi:git
county,Troms og Finnmark,2021-01-21,247,0,3548,1,1.4582160280464098,0.00041099662571770297,247,3549,fhi:git
county,Troms og Finnmark,2021-01-22,81,0,3629,1,1.49150675472954,0.00041099662571770297,81,3630,fhi:git
county,Troms og Finnmark,2021-01-23,12,0,3641,1,1.4964387142381599,0.00041099662571770297,12,3642,fhi:git
county,Troms og Finnmark,2021-01-24,0,0,3641,1,1.4964387142381599,0.00041099662571770297,0,3642,fhi:git
county,Troms og Finnmark,2021-01-25,6,0,3647,1,1.4989046939924602,0.00041099662571770297,6,3648,fhi:git
county,Troms og Finnmark,2021-01-26,73,0,3720,1,1.52890744766985,0.00041099662571770297,73,3721,fhi:git
county,Troms og Finnmark,2021-01-27,666,350,4386,351,1.8026312003978402,0.144259815626914,1016,4737,fhi:git
county,Troms og Finnmark,2021-01-28,233,267,4619,618,1.89839341419007,0.25399591469354,500,5237,fhi:git
county,Troms og Finnmark,2021-01-29,103,243,4722,861,1.94072606663899,0.353868094742942,346,5583,fhi:git
county,Troms og Finnmark,2021-01-30,0,0,4722,861,1.94072606663899,0.353868094742942,0,5583,fhi:git
county,Troms og Finnmark,2021-01-31,0,0,4722,861,1.94072606663899,0.353868094742942,0,5583,fhi:git
county,Troms og Finnmark,2021-02-01,0,2,4722,863,1.94072606663899,0.354690087994378,2,5585,fhi:git
county,Troms og Finnmark,2021-02-02,107,21,4829,884,1.98470270559079,0.363321017134449,128,5713,fhi:git
county,Troms og Finnmark,2021-02-03,991,521,5820,1405,2.3920003616770296,0.5774502591333721,1512,7225,fhi:git
nation,Norge,2020-12-27,5,0,5,0,9.31518486915891e-05,0.0,5,5,fhi:git
nation,Norge,2020-12-28,601,0,606,0,0.0112900040614206,0.0,601,606,fhi:git
nation,Norge,2020-12-29,1068,0,1674,0,0.031187238941944,0.0,1068,1674,fhi:git
nation,Norge,2020-12-30,423,0,2097,0,0.0390678853412525,0.0,423,2097,fhi:git
nation,Norge,2020-12-31,72,0,2169,0,0.0404092719624114,0.0,72,2169,fhi:git
nation,Norge,2021-01-01,6,0,2175,0,0.0405210541808413,0.0,6,2175,fhi:git
nation,Norge,2021-01-02,0,0,2175,0,0.0405210541808413,0.0,0,2175,fhi:git
nation,Norge,2021-01-03,0,0,2175,0,0.0405210541808413,0.0,0,2175,fhi:git
nation,Norge,2021-01-04,1,0,2176,0,0.0405396845505796,0.0,1,2176,fhi:git
nation,Norge,2021-01-05,3437,0,5613,0,0.10457226534117801,0.0,3437,5613,fhi:git
nation,Norge,2021-01-06,9011,0,14624,0,0.27245052705316,0.0,9011,14624,fhi:git
nation,Norge,2021-01-07,6553,0,21177,0,0.39453533994835704,0.0,6553,21177,fhi:git
nation,Norge,2021-01-08,1613,0,22790,0,0.42458612633626297,0.0,1613,22790,fhi:git
nation,Norge,2021-01-09,132,0,22922,0,0.427045335141721,0.0,132,22922,fhi:git
nation,Norge,2021-01-10,107,0,23029,0,0.42903878470372103,0.0,107,23029,fhi:git
nation,Norge,2021-01-11,342,0,23371,0,0.435410371154226,0.0,342,23371,fhi:git
nation,Norge,2021-01-12,4284,0,27655,0,0.515222875113179,0.0,4284,27655,fhi:git
nation,Norge,2021-01-13,9686,0,37341,0,0.695676636398526,0.0,9686,37341,fhi:git
nation,Norge,2021-01-14,8402,0,45743,0,0.852209002939872,0.0,8402,45743,fhi:git
nation,Norge,2021-01-15,4470,0,50213,0,0.9354867556701529,0.0,4470,50213,fhi:git
nation,Norge,2021-01-16,733,0,50946,0,0.94914281668834,0.0,733,50946,fhi:git
nation,Norge,2021-01-17,344,5,51290,5,0.9555516638783209,9.31518486915891e-05,349,51295,fhi:git
nation,Norge,2021-01-18,1259,283,52549,288,0.979007299378864,0.005365546484635529,1542,52837,fhi:git
nation,Norge,2021-01-19,4527,767,57076,1055,1.06334698318423,0.0196550400739253,5294,58131,fhi:git
nation,Norge,2021-01-20,9939,692,67015,1747,1.24851422801337,0.0325472559328412,10631,68762,fhi:git
nation,Norge,2021-01-21,8280,168,75295,1915,1.40277368944664,0.0356771580488786,8448,77210,fhi:git
nation,Norge,2021-01-22,3243,7,78538,1922,1.4631919785080099,0.0358075706370469,3250,80460,fhi:git
nation,Norge,2021-01-23,353,0,78891,1922,1.4697684990256297,0.0358075706370469,353,80813,fhi:git
nation,Norge,2021-01-24,65,0,78956,1922,1.47097947305862,0.0358075706370469,65,80878,fhi:git
nation,Norge,2021-01-25,574,0,79530,1922,1.4816733052884201,0.0358075706370469,574,81452,fhi:git
nation,Norge,2021-01-26,2201,2050,81731,3972,1.52267874908245,0.0739998286005984,4251,85703,fhi:git
nation,Norge,2021-01-27,11084,7380,92815,11352,1.7291777672619701,0.21149195726938397,18464,104167,fhi:git
nation,Norge,2021-01-28,10598,6325,103413,17677,1.92662242574866,0.32932904586424394,16923,121090,fhi:git
nation,Norge,2021-01-29,3650,1988,107063,19665,1.99462327529352,0.36636622090402,5638,126728,fhi:git
nation,Norge,2021-01-30,128,166,107191,19831,1.99700796262003,0.369458862280581,294,127022,fhi:git
nation,Norge,2021-01-31,80,50,107271,19881,1.9984983921990902,0.370390380767497,130,127152,fhi:git
nation,Norge,2021-02-01,159,297,107430,20178,2.00146062098748,0.3759236005797771,456,127608,fhi:git
nation,Norge,2021-02-02,5978,3030,113408,23208,2.11283297128315,0.43237362088688003,9008,136616,fhi:git
nation,Norge,2021-02-03,22041,6858,135449,30066,2.52346495068541,0.5601406965522641,28899,165515,fhi:git
