granularity_geo,location_name,date,new_dose_1,new_dose_2,total_dose_1,total_dose_2,total_pr100_dose_1,total_pr100_dose_2,new_doses,total_doses,source
county,Oslo,2020-12-27,5,0,5,0,0.00072098677133472,0.0,5,5,fhi:git
county,Oslo,2020-12-28,264,0,269,0,0.0387890882978079,0.0,264,269,fhi:git
county,Oslo,2020-12-29,118,0,387,0,0.0558043761013073,0.0,118,387,fhi:git
county,Oslo,2020-12-30,58,0,445,0,0.06416782264879001,0.0,58,445,fhi:git
county,Oslo,2020-12-31,5,0,450,0,0.0648888094201248,0.0,5,450,fhi:git
county,Oslo,2021-01-01,6,0,456,0,0.0657539935457264,0.0,6,456,fhi:git
county,Oslo,2021-01-02,0,0,456,0,0.0657539935457264,0.0,0,456,fhi:git
county,Oslo,2021-01-03,0,0,456,0,0.0657539935457264,0.0,0,456,fhi:git
county,Oslo,2021-01-04,0,0,456,0,0.0657539935457264,0.0,0,456,fhi:git
county,Oslo,2021-01-05,480,0,936,0,0.13496872359386,0.0,480,936,fhi:git
county,Oslo,2021-01-06,605,0,1541,0,0.22220812292536102,0.0,605,1541,fhi:git
county,Oslo,2021-01-07,967,0,2508,0,0.36164696450149497,0.0,967,2508,fhi:git
county,Oslo,2021-01-08,449,0,2957,0,0.42639157656735294,0.0,449,2957,fhi:git
county,Oslo,2021-01-09,126,0,3083,0,0.44456044320498794,0.0,126,3083,fhi:git
county,Oslo,2021-01-10,100,0,3183,0,0.458980178631683,0.0,100,3183,fhi:git
county,Oslo,2021-01-11,76,0,3259,0,0.46993917755597,0.0,76,3259,fhi:git
county,Oslo,2021-01-12,240,0,3499,0,0.5045465425800371,0.0,240,3499,fhi:git
county,Oslo,2021-01-13,488,0,3987,0,0.574914851462305,0.0,488,3987,fhi:git
county,Oslo,2021-01-14,1232,0,5219,0,0.75256599191918,0.0,1232,5219,fhi:git
county,Oslo,2021-01-15,1663,0,6882,0,0.992366192065108,0.0,1663,6882,fhi:git
county,Oslo,2021-01-16,636,0,7518,0,1.08407570937888,0.0,636,7518,fhi:git
county,Oslo,2021-01-17,274,5,7792,5,1.12358578444803,0.00072098677133472,279,7797,fhi:git
county,Oslo,2021-01-18,749,231,8541,236,1.23158960279397,0.0340305756069988,980,8777,fhi:git
county,Oslo,2021-01-19,807,69,9348,305,1.3479568676873899,0.0439801930514179,876,9653,fhi:git
county,Oslo,2021-01-20,986,99,10334,404,1.4901354589946,0.0582557311238453,1085,10738,fhi:git
county,Oslo,2021-01-21,1017,21,11351,425,1.63678416828408,0.0612838755634512,1038,11776,fhi:git
county,Oslo,2021-01-22,668,6,12019,431,1.7331080009344,0.0621490596890528,674,12450,fhi:git
county,Oslo,2021-01-23,232,0,12251,431,1.7665617871243302,0.0621490596890528,232,12682,fhi:git
county,Oslo,2021-01-24,65,0,12316,431,1.7759346151516797,0.0621490596890528,65,12747,fhi:git
county,Oslo,2021-01-25,257,0,12573,431,1.81299333519829,0.0621490596890528,257,13004,fhi:git
county,Oslo,2021-01-26,314,403,12887,834,1.85827130443811,0.12026059345863101,717,13721,fhi:git
county,Oslo,2021-01-27,997,528,13884,1362,2.0020360666422503,0.19639679651157801,1525,15246,fhi:git
county,Oslo,2021-01-28,835,842,14719,2204,2.12244085745515,0.31781096880434395,1677,16923,fhi:git
county,Oslo,2021-01-29,410,501,15129,2705,2.18156177270459,0.3900538432920829,911,17834,fhi:git
county,Oslo,2021-01-30,92,149,15221,2854,2.19482792929715,0.41153924907785794,241,18075,fhi:git
county,Oslo,2021-01-31,60,45,15281,2899,2.20347977055317,0.41802813001987005,105,18180,fhi:git
county,Oslo,2021-02-01,52,46,15333,2945,2.21097803297505,0.42466120831615,98,18278,fhi:git
county,Oslo,2021-02-02,1500,149,16833,3094,2.4272740643754704,0.44614661410192497,1649,19927,fhi:git
county,Oslo,2021-02-03,2299,457,19132,3551,2.7587837818351697,0.512044805001918,2756,22683,fhi:git
county,Oslo,2021-02-04,1991,1220,21123,4771,3.0458807141806603,0.687965577207589,3211,25894,fhi:git
county,Oslo,2021-02-05,1319,1547,22442,6318,3.23607702445876,0.9110388842585521,2866,28760,fhi:git
county,Oslo,2021-02-06,234,631,22676,6949,3.26981920535722,1.00202741480099,865,29625,fhi:git
county,Oslo,2021-02-07,212,268,22888,7217,3.30038904446181,1.04067230574453,480,30105,fhi:git
county,Oslo,2021-02-08,42,439,22930,7656,3.3064453333410198,1.10397494426772,481,30586,fhi:git
county,Oslo,2021-02-09,1075,239,24005,7895,3.46145748917799,1.13843811193752,1314,31900,fhi:git
county,Rogaland,2020-12-27,0,0,0,0,0.0,0.0,0,0,fhi:git
county,Rogaland,2020-12-28,1,0,1,0,0.00020838021888258202,0.0,1,1,fhi:git
county,Rogaland,2020-12-29,0,0,1,0,0.00020838021888258202,0.0,0,1,fhi:git
county,Rogaland,2020-12-30,0,0,1,0,0.00020838021888258202,0.0,0,1,fhi:git
county,Rogaland,2020-12-31,0,0,1,0,0.00020838021888258202,0.0,0,1,fhi:git
county,Rogaland,2021-01-01,0,0,1,0,0.00020838021888258202,0.0,0,1,fhi:git
county,Rogaland,2021-01-02,0,0,1,0,0.00020838021888258202,0.0,0,1,fhi:git
county,Rogaland,2021-01-03,0,0,1,0,0.00020838021888258202,0.0,0,1,fhi:git
county,Rogaland,2021-01-04,0,0,1,0,0.00020838021888258202,0.0,0,1,fhi:git
county,Rogaland,2021-01-05,548,0,549,0,0.11440074016653698,0.0,548,549,fhi:git
county,Rogaland,2021-01-06,641,0,1190,0,0.24797246047027302,0.0,641,1190,fhi:git
county,Rogaland,2021-01-07,211,0,1401,0,0.291940686654497,0.0,211,1401,fhi:git
county,Rogaland,2021-01-08,20,0,1421,0,0.296108291032149,0.0,20,1421,fhi:git
county,Rogaland,2021-01-09,1,0,1422,0,0.296316671251032,0.0,1,1422,fhi:git
county,Rogaland,2021-01-10,0,0,1422,0,0.296316671251032,0.0,0,1422,fhi:git
county,Rogaland,2021-01-11,1,0,1423,0,0.29652505146991404,0.0,1,1423,fhi:git
county,Rogaland,2021-01-12,129,0,1552,0,0.32340609970576695,0.0,129,1552,fhi:git
county,Rogaland,2021-01-13,762,0,2314,0,0.482191826494295,0.0,762,2314,fhi:git
county,Rogaland,2021-01-14,525,0,2839,0,0.5915914414076501,0.0,525,2839,fhi:git
county,Rogaland,2021-01-15,289,0,3128,0,0.6518133246647161,0.0,289,3128,fhi:git
county,Rogaland,2021-01-16,0,0,3128,0,0.6518133246647161,0.0,0,3128,fhi:git
county,Rogaland,2021-01-17,0,0,3128,0,0.6518133246647161,0.0,0,3128,fhi:git
county,Rogaland,2021-01-18,71,0,3199,0,0.66660832020538,0.0,71,3199,fhi:git
county,Rogaland,2021-01-19,511,0,3710,0,0.773090612054379,0.0,511,3710,fhi:git
county,Rogaland,2021-01-20,616,0,4326,0,0.9014528268860491,0.0,616,4326,fhi:git
county,Rogaland,2021-01-21,424,0,4750,0,0.989806039692264,0.0,424,4750,fhi:git
county,Rogaland,2021-01-22,266,0,5016,0,1.04523517791503,0.0,266,5016,fhi:git
county,Rogaland,2021-01-23,0,0,5016,0,1.04523517791503,0.0,0,5016,fhi:git
county,Rogaland,2021-01-24,0,0,5016,0,1.04523517791503,0.0,0,5016,fhi:git
county,Rogaland,2021-01-25,149,0,5165,0,1.07628383052854,0.0,149,5165,fhi:git
county,Rogaland,2021-01-26,338,381,5503,381,1.1467163445108501,0.0793928633942637,719,5884,fhi:git
county,Rogaland,2021-01-27,834,600,6337,981,1.32050544705892,0.204420994723813,1434,7318,fhi:git
county,Rogaland,2021-01-28,521,282,6858,1263,1.4290715410967498,0.26318421644870105,803,8121,fhi:git
county,Rogaland,2021-01-29,407,22,7265,1285,1.51388229018196,0.267768581264118,429,8550,fhi:git
county,Rogaland,2021-01-30,2,1,7267,1286,1.51429905061972,0.267976961483,3,8553,fhi:git
county,Rogaland,2021-01-31,0,0,7267,1286,1.51429905061972,0.267976961483,0,8553,fhi:git
county,Rogaland,2021-02-01,12,5,7279,1291,1.51679961324631,0.269018862577413,17,8570,fhi:git
county,Rogaland,2021-02-02,442,76,7721,1367,1.6089036699924197,0.28485575921249,518,9088,fhi:git
county,Rogaland,2021-02-03,2382,645,10103,2012,2.10526535137073,0.419261000391755,3027,12115,fhi:git
county,Rogaland,2021-02-04,1826,544,11929,2556,2.48576763105032,0.5326198394638789,2370,14485,fhi:git
county,Rogaland,2021-02-05,649,273,12578,2829,2.62100639310512,0.589507639218824,922,15407,fhi:git
county,Rogaland,2021-02-06,0,0,12578,2829,2.62100639310512,0.589507639218824,0,15407,fhi:git
county,Rogaland,2021-02-07,0,0,12578,2829,2.62100639310512,0.589507639218824,0,15407,fhi:git
county,Rogaland,2021-02-08,6,71,12584,2900,2.62225667441841,0.6043026347594879,77,15484,fhi:git
county,Rogaland,2021-02-09,492,342,13076,3242,2.72477974210864,0.675568669617331,834,16318,fhi:git
county,Møre og Romsdal,2020-12-27,0,0,0,0,0.0,0.0,0,0,fhi:git
county,Møre og Romsdal,2020-12-28,0,0,0,0,0.0,0.0,0,0,fhi:git
county,Møre og Romsdal,2020-12-29,0,0,0,0,0.0,0.0,0,0,fhi:git
county,Møre og Romsdal,2020-12-30,0,0,0,0,0.0,0.0,0,0,fhi:git
county,Møre og Romsdal,2020-12-31,0,0,0,0,0.0,0.0,0,0,fhi:git
county,Møre og Romsdal,2021-01-01,0,0,0,0,0.0,0.0,0,0,fhi:git
county,Møre og Romsdal,2021-01-02,0,0,0,0,0.0,0.0,0,0,fhi:git
county,Møre og Romsdal,2021-01-03,0,0,0,0,0.0,0.0,0,0,fhi:git
county,Møre og Romsdal,2021-01-04,0,0,0,0,0.0,0.0,0,0,fhi:git
county,Møre og Romsdal,2021-01-05,186,0,186,0,0.0701256984293352,0.0,186,186,fhi:git
county,Møre og Romsdal,2021-01-06,497,0,683,0,0.257504580791591,0.0,497,683,fhi:git
county,Møre og Romsdal,2021-01-07,457,0,1140,0,0.429802667792699,0.0,457,1140,fhi:git
county,Møre og Romsdal,2021-01-08,35,0,1175,0,0.442998363733703,0.0,35,1175,fhi:git
county,Møre og Romsdal,2021-01-09,1,0,1176,0,0.4433753836177321,0.0,1,1176,fhi:git
county,Møre og Romsdal,2021-01-10,0,0,1176,0,0.4433753836177321,0.0,0,1176,fhi:git
county,Møre og Romsdal,2021-01-11,1,0,1177,0,0.443752403501761,0.0,1,1177,fhi:git
county,Møre og Romsdal,2021-01-12,227,0,1404,0,0.529335917176272,0.0,227,1404,fhi:git
county,Møre og Romsdal,2021-01-13,387,0,1791,0,0.6752426122953721,0.0,387,1791,fhi:git
county,Møre og Romsdal,2021-01-14,410,0,2201,0,0.829820764747133,0.0,410,2201,fhi:git
county,Møre og Romsdal,2021-01-15,152,0,2353,0,0.8871277871194929,0.0,152,2353,fhi:git
county,Møre og Romsdal,2021-01-16,1,0,2354,0,0.887504807003522,0.0,1,2354,fhi:git
county,Møre og Romsdal,2021-01-17,1,0,2355,0,0.88788182688755,0.0,1,2355,fhi:git
county,Møre og Romsdal,2021-01-18,11,0,2366,0,0.892029045611866,0.0,11,2366,fhi:git
county,Møre og Romsdal,2021-01-19,180,0,2546,0,0.9598926247370291,0.0,180,2546,fhi:git
county,Møre og Romsdal,2021-01-20,488,0,3034,0,1.14387832814303,0.0,488,3034,fhi:git
county,Møre og Romsdal,2021-01-21,760,0,3794,0,1.43041344000483,0.0,760,3794,fhi:git
county,Møre og Romsdal,2021-01-22,210,0,4004,0,1.5095876156508503,0.0,210,4004,fhi:git
county,Møre og Romsdal,2021-01-23,0,0,4004,0,1.5095876156508503,0.0,0,4004,fhi:git
county,Møre og Romsdal,2021-01-24,0,0,4004,0,1.5095876156508503,0.0,0,4004,fhi:git
county,Møre og Romsdal,2021-01-25,3,0,4007,0,1.51071867530294,0.0,3,4007,fhi:git
county,Møre og Romsdal,2021-01-26,78,129,4085,129,1.5401262262571698,0.0486355650397002,207,4214,fhi:git
county,Møre og Romsdal,2021-01-27,521,357,4606,486,1.7365535858361203,0.18323166363794,878,5092,fhi:git
county,Møre og Romsdal,2021-01-28,475,508,5081,994,1.91563803074974,0.374757764724512,983,6075,fhi:git
county,Møre og Romsdal,2021-01-29,90,77,5171,1071,1.94956982031232,0.40378829579472,167,6242,fhi:git
county,Møre og Romsdal,2021-01-30,0,1,5171,1072,1.94956982031232,0.4041653156787489,1,6243,fhi:git
county,Møre og Romsdal,2021-01-31,0,0,5171,1072,1.94956982031232,0.4041653156787489,0,6243,fhi:git
county,Møre og Romsdal,2021-02-01,0,0,5171,1072,1.94956982031232,0.4041653156787489,0,6243,fhi:git
county,Møre og Romsdal,2021-02-02,279,195,5450,1267,2.0547583679563304,0.47768419306434207,474,6717,fhi:git
county,Møre og Romsdal,2021-02-03,1038,312,6488,1579,2.4461050075781,0.5953143968812921,1350,8067,fhi:git
county,Møre og Romsdal,2021-02-04,1425,463,7913,2042,2.98335834231897,0.7698746031865721,1888,9955,fhi:git
county,Møre og Romsdal,2021-02-05,201,150,8114,2192,3.0591393390087402,0.8264275857908749,351,10306,fhi:git
county,Møre og Romsdal,2021-02-06,1,2,8115,2194,3.0595163588927696,0.8271816255589319,3,10309,fhi:git
county,Møre og Romsdal,2021-02-07,0,1,8115,2195,3.0595163588927696,0.827558645442961,1,10310,fhi:git
county,Møre og Romsdal,2021-02-08,0,2,8115,2197,3.0595163588927696,0.8283126852110179,2,10312,fhi:git
county,Møre og Romsdal,2021-02-09,232,137,8347,2334,3.1469849719874197,0.8799644093229481,369,10681,fhi:git
county,Nordland,2020-12-27,0,0,0,0,0.0,0.0,0,0,fhi:git
county,Nordland,2020-12-28,0,0,0,0,0.0,0.0,0,0,fhi:git
county,Nordland,2020-12-29,0,0,0,0,0.0,0.0,0,0,fhi:git
county,Nordland,2020-12-30,1,0,1,0,0.00041453354612722,0.0,1,1,fhi:git
county,Nordland,2020-12-31,0,0,1,0,0.00041453354612722,0.0,0,1,fhi:git
county,Nordland,2021-01-01,0,0,1,0,0.00041453354612722,0.0,0,1,fhi:git
county,Nordland,2021-01-02,0,0,1,0,0.00041453354612722,0.0,0,1,fhi:git
county,Nordland,2021-01-03,0,0,1,0,0.00041453354612722,0.0,0,1,fhi:git
county,Nordland,2021-01-04,0,0,1,0,0.00041453354612722,0.0,0,1,fhi:git
county,Nordland,2021-01-05,200,0,201,0,0.0833212427715713,0.0,200,201,fhi:git
county,Nordland,2021-01-06,687,0,888,0,0.36810578896097207,0.0,687,888,fhi:git
county,Nordland,2021-01-07,238,0,1126,0,0.46676477293925,0.0,238,1126,fhi:git
county,Nordland,2021-01-08,115,0,1241,0,0.5144361307438811,0.0,115,1241,fhi:git
county,Nordland,2021-01-09,0,0,1241,0,0.5144361307438811,0.0,0,1241,fhi:git
county,Nordland,2021-01-10,0,0,1241,0,0.5144361307438811,0.0,0,1241,fhi:git
county,Nordland,2021-01-11,0,0,1241,0,0.5144361307438811,0.0,0,1241,fhi:git
county,Nordland,2021-01-12,291,0,1532,0,0.635065392666902,0.0,291,1532,fhi:git
county,Nordland,2021-01-13,626,0,2158,0,0.8945633925425419,0.0,626,2158,fhi:git
county,Nordland,2021-01-14,273,0,2431,0,1.0077310506352701,0.0,273,2431,fhi:git
county,Nordland,2021-01-15,69,0,2500,0,1.03633386531805,0.0,69,2500,fhi:git
county,Nordland,2021-01-16,0,0,2500,0,1.03633386531805,0.0,0,2500,fhi:git
county,Nordland,2021-01-17,0,0,2500,0,1.03633386531805,0.0,0,2500,fhi:git
county,Nordland,2021-01-18,0,0,2500,0,1.03633386531805,0.0,0,2500,fhi:git
county,Nordland,2021-01-19,313,0,2813,0,1.1660828652558701,0.0,313,2813,fhi:git
county,Nordland,2021-01-20,785,0,3598,0,1.4914916989657399,0.0,785,3598,fhi:git
county,Nordland,2021-01-21,613,0,4211,0,1.7456007627417298,0.0,613,4211,fhi:git
county,Nordland,2021-01-22,167,0,4378,0,1.81482786494497,0.0,167,4378,fhi:git
county,Nordland,2021-01-23,1,0,4379,0,1.8152423984911001,0.0,1,4379,fhi:git
county,Nordland,2021-01-24,0,0,4379,0,1.8152423984911001,0.0,0,4379,fhi:git
county,Nordland,2021-01-25,51,0,4430,0,1.8363836093435901,0.0,51,4430,fhi:git
county,Nordland,2021-01-26,96,90,4526,90,1.8761788297718,0.0373080191514498,186,4616,fhi:git
county,Nordland,2021-01-27,625,529,5151,619,2.13526229610131,0.256596265052749,1154,5770,fhi:git
county,Nordland,2021-01-28,469,365,5620,984,2.32967852923498,0.407901009389185,834,6604,fhi:git
county,Nordland,2021-01-29,207,145,5827,1129,2.41548697328331,0.46800837357763203,352,6956,fhi:git
county,Nordland,2021-01-30,0,0,5827,1129,2.41548697328331,0.46800837357763203,0,6956,fhi:git
county,Nordland,2021-01-31,0,0,5827,1129,2.41548697328331,0.46800837357763203,0,6956,fhi:git
county,Nordland,2021-02-01,9,4,5836,1133,2.41921777519846,0.46966650776214103,13,6969,fhi:git
county,Nordland,2021-02-02,102,199,5938,1332,2.46150019690343,0.552158683441458,301,7270,fhi:git
county,Nordland,2021-02-03,1310,420,7248,1752,3.00453914233009,0.72626277281489,1730,9000,fhi:git
county,Nordland,2021-02-04,1564,321,8812,2073,3.6528696084730696,0.859328041121728,1885,10885,fhi:git
county,Nordland,2021-02-05,322,122,9134,2195,3.7863494103260296,0.909901133749249,444,11329,fhi:git
county,Nordland,2021-02-06,0,0,9134,2195,3.7863494103260296,0.909901133749249,0,11329,fhi:git
county,Nordland,2021-02-07,1,0,9135,2195,3.7867639438721605,0.909901133749249,1,11330,fhi:git
county,Nordland,2021-02-08,6,1,9141,2196,3.7892511451489197,0.9103156672953759,7,11337,fhi:git
county,Nordland,2021-02-09,61,215,9202,2411,3.81453769146268,0.9994403797127279,276,11613,fhi:git
county,Viken,2020-12-27,0,0,0,0,0.0,0.0,0,0,fhi:git
county,Viken,2020-12-28,64,0,64,0,0.0051564457586219395,0.0,64,64,fhi:git
county,Viken,2020-12-29,690,0,754,0,0.0607493765937647,0.0,690,754,fhi:git
county,Viken,2020-12-30,216,0,970,0,0.0781523810291138,0.0,216,970,fhi:git
county,Viken,2020-12-31,67,0,1037,0,0.0835505351826711,0.0,67,1037,fhi:git
county,Viken,2021-01-01,0,0,1037,0,0.0835505351826711,0.0,0,1037,fhi:git
county,Viken,2021-01-02,0,0,1037,0,0.0835505351826711,0.0,0,1037,fhi:git
county,Viken,2021-01-03,0,0,1037,0,0.0835505351826711,0.0,0,1037,fhi:git
county,Viken,2021-01-04,0,0,1037,0,0.0835505351826711,0.0,0,1037,fhi:git
county,Viken,2021-01-05,524,0,1561,0,0.12576893483138799,0.0,524,1561,fhi:git
county,Viken,2021-01-06,1644,0,3205,0,0.258225135255989,0.0,1644,3205,fhi:git
county,Viken,2021-01-07,1916,0,5121,0,0.412596230154734,0.0,1916,5121,fhi:git
county,Viken,2021-01-08,279,0,5400,0,0.435075110883726,0.0,279,5400,fhi:git
county,Viken,2021-01-09,6,0,5406,0,0.43555852767359704,0.0,6,5406,fhi:git
county,Viken,2021-01-10,5,0,5411,0,0.435961374998489,0.0,5,5411,fhi:git
county,Viken,2021-01-11,55,0,5466,0,0.44039269557230504,0.0,55,5466,fhi:git
county,Viken,2021-01-12,785,0,6251,0,0.503639725580402,0.0,785,6251,fhi:git
county,Viken,2021-01-13,1935,0,8186,0,0.659541640313738,0.0,1935,8186,fhi:git
county,Viken,2021-01-14,1953,0,10139,0,0.816893805416685,0.0,1953,10139,fhi:git
county,Viken,2021-01-15,1041,0,11180,0,0.90076661845927,0.0,1041,11180,fhi:git
county,Viken,2021-01-16,85,0,11265,0,0.90761502298244,0.0,85,11265,fhi:git
county,Viken,2021-01-17,22,0,11287,0,0.909387551211966,0.0,22,11287,fhi:git
county,Viken,2021-01-18,141,51,11428,51,0.9207478457739301,0.00410904271390186,192,11479,fhi:git
county,Viken,2021-01-19,642,380,12070,431,0.972473442290107,0.0347254394057196,1022,12501,fhi:git
county,Viken,2021-01-20,1478,341,13548,772,1.09155511152828,0.0621996269633771,1819,14320,fhi:git
county,Viken,2021-01-21,1971,99,15519,871,1.2503575270008402,0.0701760039962455,2070,16390,fhi:git
county,Viken,2021-01-22,803,1,16322,872,1.31505480737855,0.0702565734612239,804,17194,fhi:git
county,Viken,2021-01-23,97,0,16419,872,1.32287004548146,0.0702565734612239,97,17291,fhi:git
county,Viken,2021-01-24,0,0,16419,872,1.32287004548146,0.0702565734612239,0,17291,fhi:git
county,Viken,2021-01-25,59,0,16478,872,1.32762364391519,0.0702565734612239,59,17350,fhi:git
county,Viken,2021-01-26,553,391,17031,1263,1.37217855804829,0.10175923426780499,944,18294,fhi:git
county,Viken,2021-01-27,1900,1135,18931,2398,1.5252605415073701,0.19320557701836605,3035,21329,fhi:git
county,Viken,2021-01-28,3087,1704,22018,4102,1.7739784798959,0.330495945341675,4791,26120,fhi:git
county,Viken,2021-01-29,1027,417,23045,4519,1.85672332042879,0.36409341223769603,1444,27564,fhi:git
county,Viken,2021-01-30,4,17,23049,4536,1.8570455982887,0.36546309314233005,21,27585,fhi:git
county,Viken,2021-01-31,0,3,23049,4539,1.8570455982887,0.36570480153726503,3,27588,fhi:git
county,Viken,2021-02-01,13,45,23062,4584,1.85809300133342,0.369330427461296,58,27646,fhi:git
county,Viken,2021-02-02,944,657,24006,5241,1.9341505762731002,0.42226456595215,1601,29247,fhi:git
county,Viken,2021-02-03,4489,1679,28495,6920,2.29582690456144,0.557540697650997,6168,35415,fhi:git
county,Viken,2021-02-04,6447,1718,34942,8638,2.81525824527762,0.6959590384840051,8165,43580,fhi:git
county,Viken,2021-02-05,3004,1058,37946,9696,3.05728891807294,0.7812015324312241,4062,47642,fhi:git
county,Viken,2021-02-06,37,85,37983,9781,3.0602699882771405,0.788049936954394,122,47764,fhi:git
county,Viken,2021-02-07,15,19,37998,9800,3.06147853025182,0.789580756788985,34,47798,fhi:git
county,Viken,2021-02-08,17,95,38015,9895,3.06284821115645,0.7972348559619391,112,47910,fhi:git
county,Viken,2021-02-09,710,499,38725,10394,3.12005253129117,0.8374390189861949,1209,49119,fhi:git
county,Innlandet,2020-12-27,0,0,0,0,0.0,0.0,0,0,fhi:git
county,Innlandet,2020-12-28,271,0,271,0,0.07297009841539098,0.0,271,271,fhi:git
county,Innlandet,2020-12-29,260,0,531,0,0.142978310917242,0.0,260,531,fhi:git
county,Innlandet,2020-12-30,149,0,680,0,0.18309840192791801,0.0,149,680,fhi:git
county,Innlandet,2020-12-31,0,0,680,0,0.18309840192791801,0.0,0,680,fhi:git
county,Innlandet,2021-01-01,0,0,680,0,0.18309840192791801,0.0,0,680,fhi:git
county,Innlandet,2021-01-02,0,0,680,0,0.18309840192791801,0.0,0,680,fhi:git
county,Innlandet,2021-01-03,0,0,680,0,0.18309840192791801,0.0,0,680,fhi:git
county,Innlandet,2021-01-04,0,0,680,0,0.18309840192791801,0.0,0,680,fhi:git
county,Innlandet,2021-01-05,322,0,1002,0,0.269800880487903,0.0,322,1002,fhi:git
county,Innlandet,2021-01-06,653,0,1655,0,0.44562919880985996,0.0,653,1655,fhi:git
county,Innlandet,2021-01-07,719,0,2374,0,0.639228832613057,0.0,719,2374,fhi:git
county,Innlandet,2021-01-08,76,0,2450,0,0.659692771652059,0.0,76,2450,fhi:git
county,Innlandet,2021-01-09,0,0,2450,0,0.659692771652059,0.0,0,2450,fhi:git
county,Innlandet,2021-01-10,0,0,2450,0,0.659692771652059,0.0,0,2450,fhi:git
county,Innlandet,2021-01-11,51,0,2501,0,0.673425151796653,0.0,51,2501,fhi:git
county,Innlandet,2021-01-12,443,0,2944,0,0.7927083754055759,0.0,443,2944,fhi:git
county,Innlandet,2021-01-13,953,0,3897,0,1.04931540046044,0.0,953,3897,fhi:git
county,Innlandet,2021-01-14,951,0,4848,0,1.30538390080375,0.0,951,4848,fhi:git
county,Innlandet,2021-01-15,278,0,5126,0,1.38023883570957,0.0,278,5126,fhi:git
county,Innlandet,2021-01-16,4,0,5130,0,1.3813158851326799,0.0,4,5130,fhi:git
county,Innlandet,2021-01-17,0,0,5130,0,1.3813158851326799,0.0,0,5130,fhi:git
county,Innlandet,2021-01-18,67,0,5197,0,1.39935646296969,0.0,67,5197,fhi:git
county,Innlandet,2021-01-19,331,318,5528,318,1.4884823027316698,0.0856254291368795,649,5846,fhi:git
county,Innlandet,2021-01-20,660,252,6188,570,1.66619545754406,0.15347954279252,912,6758,fhi:git
county,Innlandet,2021-01-21,829,48,7017,618,1.8894139504826497,0.166404135869785,877,7635,fhi:git
county,Innlandet,2021-01-22,237,0,7254,618,1.95322912880165,0.166404135869785,237,7872,fhi:git
county,Innlandet,2021-01-23,5,0,7259,618,1.9545754405805302,0.166404135869785,5,7877,fhi:git
county,Innlandet,2021-01-24,0,0,7259,618,1.9545754405805302,0.166404135869785,0,7877,fhi:git
county,Innlandet,2021-01-25,2,0,7261,618,1.9551139652920801,0.166404135869785,2,7879,fhi:git
county,Innlandet,2021-01-26,140,131,7401,749,1.99281069510077,0.201677504476487,271,8150,fhi:git
county,Innlandet,2021-01-27,907,550,8308,1299,2.2370316517899203,0.34977180015348,1457,9607,fhi:git
county,Innlandet,2021-01-28,895,705,9203,2004,2.4780214602097597,0.539601760975807,1600,11207,fhi:git
county,Innlandet,2021-01-29,312,132,9515,2136,2.5620313152119802,0.575144391938285,444,11651,fhi:git
county,Innlandet,2021-01-30,1,0,9516,2136,2.56230057756775,0.575144391938285,1,11652,fhi:git
county,Innlandet,2021-01-31,0,0,9516,2136,2.56230057756775,0.575144391938285,0,11652,fhi:git
county,Innlandet,2021-02-01,8,49,9524,2185,2.56445467641396,0.588338247371326,57,11709,fhi:git
county,Innlandet,2021-02-02,604,334,10128,2519,2.72708913930288,0.6782718742006271,938,12647,fhi:git
county,Innlandet,2021-02-03,2278,813,12406,3332,3.34046878576141,0.897182169446801,3091,15738,fhi:git
county,Innlandet,2021-02-04,2586,985,14992,4317,4.036781237799049,1.16240558988651,3571,19309,fhi:git
county,Innlandet,2021-02-05,806,266,15798,4583,4.25380669655479,1.23402937652302,1072,20381,fhi:git
county,Innlandet,2021-02-06,7,4,15805,4587,4.25569153304522,1.2351064259461202,11,20392,fhi:git
county,Innlandet,2021-02-07,0,0,15805,4587,4.25569153304522,1.2351064259461202,0,20392,fhi:git
county,Innlandet,2021-02-08,0,63,15805,4650,4.25569153304522,1.25206995436003,63,20455,fhi:git
county,Innlandet,2021-02-09,251,261,16056,4911,4.32327638434509,1.32234742921766,512,20967,fhi:git
county,Vestfold og Telemark,2020-12-27,0,0,0,0,0.0,0.0,0,0,fhi:git
county,Vestfold og Telemark,2020-12-28,0,0,0,0,0.0,0.0,0,0,fhi:git
county,Vestfold og Telemark,2020-12-29,0,0,0,0,0.0,0.0,0,0,fhi:git
county,Vestfold og Telemark,2020-12-30,0,0,0,0,0.0,0.0,0,0,fhi:git
county,Vestfold og Telemark,2020-12-31,0,0,0,0,0.0,0.0,0,0,fhi:git
county,Vestfold og Telemark,2021-01-01,0,0,0,0,0.0,0.0,0,0,fhi:git
county,Vestfold og Telemark,2021-01-02,0,0,0,0,0.0,0.0,0,0,fhi:git
county,Vestfold og Telemark,2021-01-03,0,0,0,0,0.0,0.0,0,0,fhi:git
county,Vestfold og Telemark,2021-01-04,1,0,1,0,0.00023843813484153399,0.0,1,1,fhi:git
county,Vestfold og Telemark,2021-01-05,218,0,219,0,0.052217951530296,0.0,218,219,fhi:git
county,Vestfold og Telemark,2021-01-06,1026,0,1245,0,0.29685547787771,0.0,1026,1245,fhi:git
county,Vestfold og Telemark,2021-01-07,442,0,1687,0,0.40224513347766794,0.0,442,1687,fhi:git
county,Vestfold og Telemark,2021-01-08,64,0,1751,0,0.417505174107526,0.0,64,1751,fhi:git
county,Vestfold og Telemark,2021-01-09,0,0,1751,0,0.417505174107526,0.0,0,1751,fhi:git
county,Vestfold og Telemark,2021-01-10,2,0,1753,0,0.417982050377209,0.0,2,1753,fhi:git
county,Vestfold og Telemark,2021-01-11,2,0,1755,0,0.41845892664689205,0.0,2,1755,fhi:git
county,Vestfold og Telemark,2021-01-12,419,0,2174,0,0.518364505145495,0.0,419,2174,fhi:git
county,Vestfold og Telemark,2021-01-13,1167,0,3341,0,0.796621808505565,0.0,1167,3341,fhi:git
county,Vestfold og Telemark,2021-01-14,586,0,3927,0,0.9363465555227041,0.0,586,3927,fhi:git
county,Vestfold og Telemark,2021-01-15,157,0,4084,0,0.9737813426928249,0.0,157,4084,fhi:git
county,Vestfold og Telemark,2021-01-16,3,0,4087,0,0.9744966570973491,0.0,3,4087,fhi:git
county,Vestfold og Telemark,2021-01-17,39,0,4126,0,0.9837957443561691,0.0,39,4126,fhi:git
county,Vestfold og Telemark,2021-01-18,5,0,4131,0,0.9849879350303771,0.0,5,4131,fhi:git
county,Vestfold og Telemark,2021-01-19,227,0,4358,0,1.0391133916394102,0.0,227,4358,fhi:git
county,Vestfold og Telemark,2021-01-20,1602,0,5960,0,1.42109128365554,0.0,1602,5960,fhi:git
county,Vestfold og Telemark,2021-01-21,816,0,6776,0,1.61565680168623,0.0,816,6776,fhi:git
county,Vestfold og Telemark,2021-01-22,178,0,6954,0,1.65809878968803,0.0,178,6954,fhi:git
county,Vestfold og Telemark,2021-01-23,3,0,6957,0,1.65881410409255,0.0,3,6957,fhi:git
county,Vestfold og Telemark,2021-01-24,0,0,6957,0,1.65881410409255,0.0,0,6957,fhi:git
county,Vestfold og Telemark,2021-01-25,45,0,7002,0,1.66954382016042,0.0,45,7002,fhi:git
county,Vestfold og Telemark,2021-01-26,103,178,7105,178,1.6941029480491,0.0424419880017931,281,7283,fhi:git
county,Vestfold og Telemark,2021-01-27,1621,898,8726,1076,2.08061116462723,0.25655943308949103,2519,9802,fhi:git
county,Vestfold og Telemark,2021-01-28,651,448,9377,1524,2.2358343904090603,0.36337971749849796,1099,10901,fhi:git
county,Vestfold og Telemark,2021-01-29,86,90,9463,1614,2.25634007000544,0.38483914963423604,176,11077,fhi:git
county,Vestfold og Telemark,2021-01-30,0,0,9463,1614,2.25634007000544,0.38483914963423604,0,11077,fhi:git
county,Vestfold og Telemark,2021-01-31,0,1,9463,1615,2.25634007000544,0.38507758776907797,1,11078,fhi:git
county,Vestfold og Telemark,2021-02-01,49,0,9512,1615,2.26802353861267,0.38507758776907797,49,11127,fhi:git
county,Vestfold og Telemark,2021-02-02,458,326,9970,1941,2.37722820437009,0.462808419727418,784,11911,fhi:git
county,Vestfold og Telemark,2021-02-03,3195,833,13165,2774,3.1390380451888,0.6614273860504151,4028,15939,fhi:git
county,Vestfold og Telemark,2021-02-04,1883,698,15048,3472,3.5880170530954,0.8278572041698059,2581,18520,fhi:git
county,Vestfold og Telemark,2021-02-05,942,234,15990,3706,3.8126257761161297,0.8836517277227249,1176,19696,fhi:git
county,Vestfold og Telemark,2021-02-06,0,4,15990,3710,3.8126257761161297,0.884605480262091,4,19700,fhi:git
county,Vestfold og Telemark,2021-02-07,2,1,15992,3711,3.81310265238581,0.8848439183969329,3,19703,fhi:git
county,Vestfold og Telemark,2021-02-08,17,46,16009,3757,3.8171561006781203,0.8958120725996429,63,19766,fhi:git
county,Vestfold og Telemark,2021-02-09,336,186,16345,3943,3.8972713139848705,0.9401615656801691,522,20288,fhi:git
county,Agder,2020-12-27,0,0,0,0,0.0,0.0,0,0,fhi:git
county,Agder,2020-12-28,0,0,0,0,0.0,0.0,0,0,fhi:git
county,Agder,2020-12-29,0,0,0,0,0.0,0.0,0,0,fhi:git
county,Agder,2020-12-30,0,0,0,0,0.0,0.0,0,0,fhi:git
county,Agder,2020-12-31,0,0,0,0,0.0,0.0,0,0,fhi:git
county,Agder,2021-01-01,0,0,0,0,0.0,0.0,0,0,fhi:git
county,Agder,2021-01-02,0,0,0,0,0.0,0.0,0,0,fhi:git
county,Agder,2021-01-03,0,0,0,0,0.0,0.0,0,0,fhi:git
county,Agder,2021-01-04,0,0,0,0,0.0,0.0,0,0,fhi:git
county,Agder,2021-01-05,79,0,79,0,0.0257135510413988,0.0,79,79,fhi:git
county,Agder,2021-01-06,791,0,870,0,0.283174549443253,0.0,791,870,fhi:git
county,Agder,2021-01-07,230,0,1100,0,0.35803678665238897,0.0,230,1100,fhi:git
county,Agder,2021-01-08,49,0,1149,0,0.37398569805781295,0.0,49,1149,fhi:git
county,Agder,2021-01-09,0,0,1149,0,0.37398569805781295,0.0,0,1149,fhi:git
county,Agder,2021-01-10,0,0,1149,0,0.37398569805781295,0.0,0,1149,fhi:git
county,Agder,2021-01-11,0,0,1149,0,0.37398569805781295,0.0,0,1149,fhi:git
county,Agder,2021-01-12,225,0,1374,0,0.44722049532762,0.0,225,1374,fhi:git
county,Agder,2021-01-13,851,0,2225,0,0.724210773001422,0.0,851,2225,fhi:git
county,Agder,2021-01-14,510,0,2735,0,0.8902096468129841,0.0,510,2735,fhi:git
county,Agder,2021-01-15,118,0,2853,0,0.92861722938115,0.0,118,2853,fhi:git
county,Agder,2021-01-16,0,0,2853,0,0.92861722938115,0.0,0,2853,fhi:git
county,Agder,2021-01-17,2,0,2855,0,0.929268205356881,0.0,2,2855,fhi:git
county,Agder,2021-01-18,15,0,2870,0,0.934150525174868,0.0,15,2870,fhi:git
county,Agder,2021-01-19,348,0,3218,0,1.0474203449521702,0.0,348,3218,fhi:git
county,Agder,2021-01-20,458,0,3676,0,1.1964938433947099,0.0,458,3676,fhi:git
county,Agder,2021-01-21,336,0,4012,0,1.3058578073176201,0.0,336,4012,fhi:git
county,Agder,2021-01-22,62,0,4074,0,1.3260380625653,0.0,62,4074,fhi:git
county,Agder,2021-01-23,1,0,4075,0,1.32636355055317,0.0,1,4075,fhi:git
county,Agder,2021-01-24,0,0,4075,0,1.32636355055317,0.0,0,4075,fhi:git
county,Agder,2021-01-25,1,0,4076,0,1.32668903854103,0.0,1,4076,fhi:git
county,Agder,2021-01-26,62,66,4138,66,1.34686929378871,0.0214822071991433,128,4204,fhi:git
county,Agder,2021-01-27,552,680,4690,746,1.52653866309064,0.242814038947893,1232,5436,fhi:git
county,Agder,2021-01-28,925,248,5615,994,1.82761505186651,0.32353505993861303,1173,6609,fhi:git
county,Agder,2021-01-29,193,61,5808,1055,1.89043423352461,0.34338982719842703,254,6863,fhi:git
county,Agder,2021-01-30,29,0,5837,1055,1.8998733851727199,0.34338982719842703,29,6892,fhi:git
county,Agder,2021-01-31,20,0,5857,1055,1.90638314493004,0.34338982719842703,20,6912,fhi:git
county,Agder,2021-02-01,0,1,5857,1056,1.90638314493004,0.34371531518629306,1,6913,fhi:git
county,Agder,2021-02-02,201,170,6058,1226,1.97180623049106,0.39904827312348,371,7284,fhi:git
county,Agder,2021-02-03,1314,588,7372,1814,2.3994974465467402,0.590435209988575,1902,9186,fhi:git
county,Agder,2021-02-04,1661,501,9033,2315,2.94013299439184,0.753504691909345,2162,11348,fhi:git
county,Agder,2021-02-05,575,133,9608,2448,3.12728858741468,0.796794594295498,708,12056,fhi:git
county,Agder,2021-02-06,408,1,10016,2449,3.26008768646393,0.7971200822833628,409,12465,fhi:git
county,Agder,2021-02-07,83,2,10099,2451,3.28710318945679,0.797771058259095,85,12550,fhi:git
county,Agder,2021-02-08,13,2,10112,2453,3.29133453329905,0.798422034234827,15,12565,fhi:git
county,Agder,2021-02-09,173,181,10285,2634,3.34764395519983,0.8573353600385379,354,12919,fhi:git
county,Vestland,2020-12-27,0,0,0,0,0.0,0.0,0,0,fhi:git
county,Vestland,2020-12-28,0,0,0,0,0.0,0.0,0,0,fhi:git
county,Vestland,2020-12-29,0,0,0,0,0.0,0.0,0,0,fhi:git
county,Vestland,2020-12-30,0,0,0,0,0.0,0.0,0,0,fhi:git
county,Vestland,2020-12-31,0,0,0,0,0.0,0.0,0,0,fhi:git
county,Vestland,2021-01-01,0,0,0,0,0.0,0.0,0,0,fhi:git
county,Vestland,2021-01-02,0,0,0,0,0.0,0.0,0,0,fhi:git
county,Vestland,2021-01-03,0,0,0,0,0.0,0.0,0,0,fhi:git
county,Vestland,2021-01-04,2,0,2,0,0.00031420307887597003,0.0,2,2,fhi:git
county,Vestland,2021-01-05,416,0,418,0,0.0656684434850777,0.0,416,418,fhi:git
county,Vestland,2021-01-06,1250,0,1668,0,0.262045367782559,0.0,1250,1668,fhi:git
county,Vestland,2021-01-07,714,0,2382,0,0.37421586694128,0.0,714,2382,fhi:git
county,Vestland,2021-01-08,139,0,2521,0,0.39605298092315994,0.0,139,2521,fhi:git
county,Vestland,2021-01-09,0,0,2521,0,0.39605298092315994,0.0,0,2521,fhi:git
county,Vestland,2021-01-10,0,0,2521,0,0.39605298092315994,0.0,0,2521,fhi:git
county,Vestland,2021-01-11,65,0,2586,0,0.406264580986629,0.0,65,2586,fhi:git
county,Vestland,2021-01-12,855,0,3441,0,0.540586397206106,0.0,855,3441,fhi:git
county,Vestland,2021-01-13,1125,0,4566,0,0.717325629073839,0.0,1125,4566,fhi:git
county,Vestland,2021-01-14,995,0,5561,0,0.873641660814634,0.0,995,5561,fhi:git
county,Vestland,2021-01-15,424,0,5985,0,0.94025271353634,0.0,424,5985,fhi:git
county,Vestland,2021-01-16,2,0,5987,0,0.940566916615216,0.0,2,5987,fhi:git
county,Vestland,2021-01-17,1,0,5988,0,0.940724018154654,0.0,1,5988,fhi:git
county,Vestland,2021-01-18,57,0,6045,0,0.9496788059026191,0.0,57,6045,fhi:git
county,Vestland,2021-01-19,370,0,6415,0,1.00780637549467,0.0,370,6415,fhi:git
county,Vestland,2021-01-20,1234,0,7649,0,1.20166967516115,0.0,1234,7649,fhi:git
county,Vestland,2021-01-21,779,0,8428,0,1.32405177438334,0.0,779,8428,fhi:git
county,Vestland,2021-01-22,310,0,8738,0,1.3727532516091103,0.0,310,8738,fhi:git
county,Vestland,2021-01-23,0,0,8738,0,1.3727532516091103,0.0,0,8738,fhi:git
county,Vestland,2021-01-24,0,0,8738,0,1.3727532516091103,0.0,0,8738,fhi:git
county,Vestland,2021-01-25,1,0,8739,0,1.37291035314855,0.0,1,8739,fhi:git
county,Vestland,2021-01-26,152,174,8891,174,1.39678978714312,0.0273356678622094,326,9065,fhi:git
county,Vestland,2021-01-27,1575,1204,10466,1378,1.6442247117579498,0.216485921345543,2779,11844,fhi:git
county,Vestland,2021-01-28,1917,677,12383,2055,1.94538836286057,0.32284366354505895,2594,14438,fhi:git
county,Vestland,2021-01-29,472,165,12855,2220,2.0195402894753,0.348765417552327,637,15075,fhi:git
county,Vestland,2021-01-30,1,0,12856,2220,2.0196973910147302,0.348765417552327,1,15076,fhi:git
county,Vestland,2021-01-31,0,0,12856,2220,2.0196973910147302,0.348765417552327,0,15076,fhi:git
county,Vestland,2021-02-01,13,59,12869,2279,2.02173971102743,0.358034408379168,72,15148,fhi:git
county,Vestland,2021-02-02,703,579,13572,2858,2.13218209325233,0.448996199713761,1282,16430,fhi:git
county,Vestland,2021-02-03,2781,1037,16353,3895,2.56908147442937,0.611910496110951,3818,20248,fhi:git
county,Vestland,2021-02-04,2487,1054,18840,4949,2.95979300301164,0.7774955186785871,3541,23789,fhi:git
county,Vestland,2021-02-05,821,484,19661,5433,3.08877336689022,0.853532663766572,1305,25094,fhi:git
county,Vestland,2021-02-06,0,2,19661,5435,3.08877336689022,0.853846866845448,2,25096,fhi:git
county,Vestland,2021-02-07,2,1,19663,5436,3.0890875699691005,0.8540039683848859,3,25099,fhi:git
county,Vestland,2021-02-08,12,49,19675,5485,3.09097278844235,0.861701943817348,61,25160,fhi:git
county,Vestland,2021-02-09,808,297,20483,5782,3.21791083230825,0.908361101030429,1105,26265,fhi:git
county,Trøndelag,2020-12-27,0,0,0,0,0.0,0.0,0,0,fhi:git
county,Trøndelag,2020-12-28,0,0,0,0,0.0,0.0,0,0,fhi:git
county,Trøndelag,2020-12-29,0,0,0,0,0.0,0.0,0,0,fhi:git
county,Trøndelag,2020-12-30,0,0,0,0,0.0,0.0,0,0,fhi:git
county,Trøndelag,2020-12-31,0,0,0,0,0.0,0.0,0,0,fhi:git
county,Trøndelag,2021-01-01,0,0,0,0,0.0,0.0,0,0,fhi:git
county,Trøndelag,2021-01-02,0,0,0,0,0.0,0.0,0,0,fhi:git
county,Trøndelag,2021-01-03,0,0,0,0,0.0,0.0,0,0,fhi:git
county,Trøndelag,2021-01-04,3,0,3,0,0.000640065542711574,0.0,3,3,fhi:git
county,Trøndelag,2021-01-05,406,0,409,0,0.0872622689896779,0.0,406,409,fhi:git
county,Trøndelag,2021-01-06,674,0,1083,0,0.231063660918878,0.0,674,1083,fhi:git
county,Trøndelag,2021-01-07,482,0,1565,0,0.333900858114538,0.0,482,1565,fhi:git
county,Trøndelag,2021-01-08,140,0,1705,0,0.36377058344107793,0.0,140,1705,fhi:git
county,Trøndelag,2021-01-09,0,0,1705,0,0.36377058344107793,0.0,0,1705,fhi:git
county,Trøndelag,2021-01-10,0,0,1705,0,0.36377058344107793,0.0,0,1705,fhi:git
county,Trøndelag,2021-01-11,95,0,1800,0,0.384039325626944,0.0,95,1800,fhi:git
county,Trøndelag,2021-01-12,500,0,2300,0,0.49071691607887297,0.0,500,2300,fhi:git
county,Trøndelag,2021-01-13,857,0,3157,0,0.673562306113479,0.0,857,3157,fhi:git
county,Trøndelag,2021-01-14,667,0,3824,0,0.815870211776353,0.0,667,3824,fhi:git
county,Trøndelag,2021-01-15,253,0,4077,0,0.8698490725450291,0.0,253,4077,fhi:git
county,Trøndelag,2021-01-16,0,0,4077,0,0.8698490725450291,0.0,0,4077,fhi:git
county,Trøndelag,2021-01-17,0,0,4077,0,0.8698490725450291,0.0,0,4077,fhi:git
county,Trøndelag,2021-01-18,155,0,4232,0,0.902919125585127,0.0,155,4232,fhi:git
county,Trøndelag,2021-01-19,568,0,4800,0,1.02410486833852,0.0,568,4800,fhi:git
county,Trøndelag,2021-01-20,727,0,5527,0,1.17921408485562,0.0,727,5527,fhi:git
county,Trøndelag,2021-01-21,495,0,6022,0,1.28482489940303,0.0,495,6022,fhi:git
county,Trøndelag,2021-01-22,284,0,6306,0,1.3454177707797301,0.0,284,6306,fhi:git
county,Trøndelag,2021-01-23,1,0,6307,0,1.34563112596063,0.0,1,6307,fhi:git
county,Trøndelag,2021-01-24,0,0,6307,0,1.34563112596063,0.0,0,6307,fhi:git
county,Trøndelag,2021-01-25,1,0,6308,0,1.3458444811415402,0.0,1,6308,fhi:git
county,Trøndelag,2021-01-26,314,184,6622,184,1.4128380079453502,0.0392573532863098,498,6806,fhi:git
county,Trøndelag,2021-01-27,956,590,7578,774,1.6168055608894398,0.165136910019586,1546,8352,fhi:git
county,Trøndelag,2021-01-28,699,473,8277,1247,1.76594083234123,0.26605391058711103,1172,9524,fhi:git
county,Trøndelag,2021-01-29,386,202,8663,1449,1.8482959321701202,0.30915165712969,588,10112,fhi:git
county,Trøndelag,2021-01-30,0,0,8663,1449,1.8482959321701202,0.30915165712969,0,10112,fhi:git
county,Trøndelag,2021-01-31,0,1,8663,1450,1.8482959321701202,0.309365012310594,1,10113,fhi:git
county,Trøndelag,2021-02-01,3,86,8666,1536,1.84893599771283,0.32771355786832596,89,10202,fhi:git
county,Trøndelag,2021-02-02,826,392,9492,1928,2.02516737713942,0.4113487887826379,1218,11420,fhi:git
county,Trøndelag,2021-02-03,2008,804,11500,2732,2.45358458039437,0.58288635422934,2812,14232,fhi:git
county,Trøndelag,2021-02-04,2055,567,13555,3299,2.89202947715179,0.703858741801827,2622,16854,fhi:git
county,Trøndelag,2021-02-05,1253,301,14808,3600,3.15936351882433,0.768078651253888,1554,18408,fhi:git
county,Trøndelag,2021-02-06,7,0,14815,3600,3.1608570050906497,0.768078651253888,7,18415,fhi:git
county,Trøndelag,2021-02-07,1,0,14816,3600,3.1610703602715597,0.768078651253888,1,18416,fhi:git
county,Trøndelag,2021-02-08,3,150,14819,3750,3.16171042581427,0.800081928389467,153,18569,fhi:git
county,Trøndelag,2021-02-09,786,521,15605,4271,3.3294075980046998,0.9112399776403771,1307,19876,fhi:git
county,Troms og Finnmark,2020-12-27,0,0,0,0,0.0,0.0,0,0,fhi:git
county,Troms og Finnmark,2020-12-28,1,0,1,0,0.00041099662571770297,0.0,1,1,fhi:git
county,Troms og Finnmark,2020-12-29,0,0,1,0,0.00041099662571770297,0.0,0,1,fhi:git
county,Troms og Finnmark,2020-12-30,0,0,1,0,0.00041099662571770297,0.0,0,1,fhi:git
county,Troms og Finnmark,2020-12-31,0,0,1,0,0.00041099662571770297,0.0,0,1,fhi:git
county,Troms og Finnmark,2021-01-01,0,0,1,0,0.00041099662571770297,0.0,0,1,fhi:git
county,Troms og Finnmark,2021-01-02,0,0,1,0,0.00041099662571770297,0.0,0,1,fhi:git
county,Troms og Finnmark,2021-01-03,0,0,1,0,0.00041099662571770297,0.0,0,1,fhi:git
county,Troms og Finnmark,2021-01-04,0,0,1,0,0.00041099662571770297,0.0,0,1,fhi:git
county,Troms og Finnmark,2021-01-05,53,0,54,0,0.022193817788756,0.0,53,54,fhi:git
county,Troms og Finnmark,2021-01-06,528,0,582,0,0.23920003616770302,0.0,528,582,fhi:git
county,Troms og Finnmark,2021-01-07,188,0,770,0,0.31646740180263105,0.0,188,770,fhi:git
county,Troms og Finnmark,2021-01-08,247,0,1017,0,0.41798356835490397,0.0,247,1017,fhi:git
county,Troms og Finnmark,2021-01-09,0,0,1017,0,0.41798356835490397,0.0,0,1017,fhi:git
county,Troms og Finnmark,2021-01-10,0,0,1017,0,0.41798356835490397,0.0,0,1017,fhi:git
county,Troms og Finnmark,2021-01-11,1,0,1018,0,0.418394564980622,0.0,1,1018,fhi:git
county,Troms og Finnmark,2021-01-12,188,0,1206,0,0.49566193061555,0.0,188,1206,fhi:git
county,Troms og Finnmark,2021-01-13,568,0,1774,0,0.7291080140232049,0.0,568,1774,fhi:git
county,Troms og Finnmark,2021-01-14,329,0,2103,0,0.8643259038843291,0.0,329,2103,fhi:git
county,Troms og Finnmark,2021-01-15,37,0,2140,0,0.879532779035884,0.0,37,2140,fhi:git
county,Troms og Finnmark,2021-01-16,2,0,2142,0,0.8803547722873192,0.0,2,2142,fhi:git
county,Troms og Finnmark,2021-01-17,1,0,2143,0,0.880765768913037,0.0,1,2143,fhi:git
county,Troms og Finnmark,2021-01-18,0,1,2143,1,0.880765768913037,0.00041099662571770297,1,2144,fhi:git
county,Troms og Finnmark,2021-01-19,249,0,2392,1,0.9831039287167449,0.00041099662571770297,249,2393,fhi:git
county,Troms og Finnmark,2021-01-20,909,0,3301,1,1.3566998614941401,0.00041099662571770297,909,3302,fhi:git
county,Troms og Finnmark,2021-01-21,247,0,3548,1,1.4582160280464098,0.00041099662571770297,247,3549,fhi:git
county,Troms og Finnmark,2021-01-22,81,0,3629,1,1.49150675472954,0.00041099662571770297,81,3630,fhi:git
county,Troms og Finnmark,2021-01-23,12,0,3641,1,1.4964387142381599,0.00041099662571770297,12,3642,fhi:git
county,Troms og Finnmark,2021-01-24,0,0,3641,1,1.4964387142381599,0.00041099662571770297,0,3642,fhi:git
county,Troms og Finnmark,2021-01-25,6,0,3647,1,1.4989046939924602,0.00041099662571770297,6,3648,fhi:git
county,Troms og Finnmark,2021-01-26,84,0,3731,1,1.53342841055275,0.00041099662571770297,84,3732,fhi:git
county,Troms og Finnmark,2021-01-27,673,351,4404,352,1.81002913966076,0.14467081225263098,1024,4756,fhi:git
county,Troms og Finnmark,2021-01-28,234,275,4638,627,1.90620235007871,0.257694884325,509,5265,fhi:git
county,Troms og Finnmark,2021-01-29,103,243,4741,870,1.94853500252763,0.357567064374401,346,5611,fhi:git
county,Troms og Finnmark,2021-01-30,0,0,4741,870,1.94853500252763,0.357567064374401,0,5611,fhi:git
county,Troms og Finnmark,2021-01-31,0,0,4741,870,1.94853500252763,0.357567064374401,0,5611,fhi:git
county,Troms og Finnmark,2021-02-01,0,2,4741,872,1.94853500252763,0.358389057625837,2,5613,fhi:git
county,Troms og Finnmark,2021-02-02,120,21,4861,893,1.99785459761375,0.36701998676590897,141,5754,fhi:git
county,Troms og Finnmark,2021-02-03,1147,560,6008,1453,2.46926772731196,0.597178097167822,1707,7461,fhi:git
county,Troms og Finnmark,2021-02-04,1088,369,7096,1822,2.9164320560928196,0.748835852057655,1457,8918,fhi:git
county,Troms og Finnmark,2021-02-05,278,140,7374,1962,3.0306891180423396,0.806375379658133,418,9336,fhi:git
county,Troms og Finnmark,2021-02-06,0,1,7374,1963,3.0306891180423396,0.806786376283851,1,9337,fhi:git
county,Troms og Finnmark,2021-02-07,0,1,7374,1964,3.0306891180423396,0.8071973729095692,1,9338,fhi:git
county,Troms og Finnmark,2021-02-08,0,0,7374,1964,3.0306891180423396,0.8071973729095692,0,9338,fhi:git
county,Troms og Finnmark,2021-02-09,43,20,7417,1984,3.0483619729482,0.815417305423923,63,9401,fhi:git
nation,Norge,2020-12-27,5,0,5,0,9.31518486915891e-05,0.0,5,5,fhi:git
nation,Norge,2020-12-28,601,0,606,0,0.0112900040614206,0.0,601,606,fhi:git
nation,Norge,2020-12-29,1068,0,1674,0,0.031187238941944,0.0,1068,1674,fhi:git
nation,Norge,2020-12-30,424,0,2098,0,0.0390865157109908,0.0,424,2098,fhi:git
nation,Norge,2020-12-31,72,0,2170,0,0.0404279023321497,0.0,72,2170,fhi:git
nation,Norge,2021-01-01,6,0,2176,0,0.0405396845505796,0.0,6,2176,fhi:git
nation,Norge,2021-01-02,0,0,2176,0,0.0405396845505796,0.0,0,2176,fhi:git
nation,Norge,2021-01-03,0,0,2176,0,0.0405396845505796,0.0,0,2176,fhi:git
nation,Norge,2021-01-04,6,0,2182,0,0.0406514667690095,0.0,6,2182,fhi:git
nation,Norge,2021-01-05,3434,0,5616,0,0.10462815645039301,0.0,3434,5616,fhi:git
nation,Norge,2021-01-06,9006,0,14622,0,0.272413266313683,0.0,9006,14622,fhi:git
nation,Norge,2021-01-07,6566,0,21188,0,0.39474027401547795,0.0,6566,21188,fhi:git
nation,Norge,2021-01-08,1613,0,22801,0,0.424791060403385,0.0,1613,22801,fhi:git
nation,Norge,2021-01-09,134,0,22935,0,0.427287529948319,0.0,134,22935,fhi:git
nation,Norge,2021-01-10,107,0,23042,0,0.42928097951031896,0.0,107,23042,fhi:git
nation,Norge,2021-01-11,348,0,23390,0,0.4357643481792539,0.0,348,23390,fhi:git
nation,Norge,2021-01-12,4303,0,27693,0,0.5159308291632361,0.0,4303,27693,fhi:git
nation,Norge,2021-01-13,9724,0,37417,0,0.6970925444986379,0.0,9724,37417,fhi:git
nation,Norge,2021-01-14,8446,0,45863,0,0.8544446473084709,0.0,8446,45863,fhi:git
nation,Norge,2021-01-15,4491,0,50354,0,0.938113637803256,0.0,4491,50354,fhi:git
nation,Norge,2021-01-16,733,0,51087,0,0.951769698821443,0.0,733,51087,fhi:git
nation,Norge,2021-01-17,341,5,51428,5,0.958122654902209,9.31518486915891e-05,346,51433,fhi:git
nation,Norge,2021-01-18,1272,283,52700,288,0.9818204852093491,0.005365546484635529,1555,52988,fhi:git
nation,Norge,2021-01-19,4551,767,57251,1055,1.06660729788843,0.0196550400739253,5318,58306,fhi:git
nation,Norge,2021-01-20,9954,692,67205,1747,1.25205399826365,0.0325472559328412,10646,68952,fhi:git
nation,Norge,2021-01-21,8296,168,75501,1915,1.4066115456127302,0.0356771580488786,8464,77416,fhi:git
nation,Norge,2021-01-22,3273,7,78774,1922,1.46758874576625,0.0358075706370469,3280,80696,fhi:git
nation,Norge,2021-01-23,353,0,79127,1922,1.47416526628387,0.0358075706370469,353,81049,fhi:git
nation,Norge,2021-01-24,65,0,79192,1922,1.4753762403168702,0.0358075706370469,65,81114,fhi:git
nation,Norge,2021-01-25,575,0,79767,1922,1.4860887029163998,0.0358075706370469,575,81689,fhi:git
nation,Norge,2021-01-26,2234,2129,82001,4051,1.5277089489118,0.0754716278099255,4363,86052,fhi:git
nation,Norge,2021-01-27,11170,7428,93171,11479,1.73581017888881,0.21385801422615,18598,104650,fhi:git
nation,Norge,2021-01-28,10715,6531,103886,18010,1.93543459063489,0.335532958987104,17246,121896,fhi:git
nation,Norge,2021-01-29,3701,2056,107587,20066,2.0043855890364,0.37383699916908597,5757,127653,fhi:git
nation,Norge,2021-01-30,129,168,107716,20234,2.00678890673264,0.376966901285123,297,127950,fhi:git
nation,Norge,2021-01-31,80,50,107796,20284,2.00827933631171,0.377898419772039,130,128080,fhi:git
nation,Norge,2021-02-01,159,298,107955,20582,2.0112415651001,0.383450269954058,457,128537,fhi:git
nation,Norge,2021-02-02,6182,3098,114137,23680,2.12641451082238,0.44116715540336604,9280,137817,fhi:git
nation,Norge,2021-02-03,24257,8152,138394,31832,2.57833138956476,0.593041929510133,32409,170226,fhi:git
nation,Norge,2021-02-04,25033,8452,163427,40284,3.04470543522407,0.7505058145383949,33485,203711,fhi:git
nation,Norge,2021-02-05,10177,4714,173604,44998,3.23430670805093,0.8383293774848259,14891,218602,fhi:git
nation,Norge,2021-02-06,694,731,174298,45729,3.24723618464932,0.8519481777635358,1425,220027,fhi:git
nation,Norge,2021-02-07,316,294,174614,46023,3.25312338148663,0.8574255064666009,610,220637,fhi:git
nation,Norge,2021-02-08,117,919,174731,46942,3.2553031347460095,0.8745468162561161,1036,221673,fhi:git
nation,Norge,2021-02-09,4967,2899,179698,49841,3.3478401812362404,0.9285562581274991,7866,229539,fhi:git
