granularity_geo,location_name,date,new_dose_1,new_dose_2,total_dose_1,total_dose_2,total_pr100_dose_1,total_pr100_dose_2,new_doses,total_doses,source
county,Agder,2020-12-27,0,0,0,0,0.0,0.0,0,0,fhi:git
county,Agder,2020-12-28,0,0,0,0,0.0,0.0,0,0,fhi:git
county,Agder,2020-12-29,0,0,0,0,0.0,0.0,0,0,fhi:git
county,Agder,2020-12-30,0,0,0,0,0.0,0.0,0,0,fhi:git
county,Agder,2020-12-31,0,0,0,0,0.0,0.0,0,0,fhi:git
county,Agder,2021-01-01,0,0,0,0,0.0,0.0,0,0,fhi:git
county,Agder,2021-01-02,0,0,0,0,0.0,0.0,0,0,fhi:git
county,Agder,2021-01-03,3,0,3,0,0.000976463963597423,0.0,3,3,fhi:git
county,Agder,2021-01-04,0,0,3,0,0.000971367329031255,0.0,0,3,fhi:git
county,Agder,2021-01-05,79,0,82,0,0.026550706993521002,0.0,79,82,fhi:git
county,Agder,2021-01-06,791,0,873,0,0.282667892748095,0.0,791,873,fhi:git
county,Agder,2021-01-07,230,0,1103,0,0.35713938797382505,0.0,230,1103,fhi:git
county,Agder,2021-01-08,49,0,1152,0,0.373005054348002,0.0,49,1152,fhi:git
county,Agder,2021-01-09,0,0,1152,0,0.373005054348002,0.0,0,1152,fhi:git
county,Agder,2021-01-10,0,0,1152,0,0.373005054348002,0.0,0,1152,fhi:git
county,Agder,2021-01-11,1,0,1153,0,0.3733288434576789,0.0,1,1153,fhi:git
county,Agder,2021-01-12,226,0,1379,0,0.44650518224470004,0.0,226,1379,fhi:git
county,Agder,2021-01-13,847,0,2226,0,0.7207545581411908,0.0,847,2226,fhi:git
county,Agder,2021-01-14,512,0,2738,0,0.886534582295859,0.0,512,2738,fhi:git
county,Agder,2021-01-15,119,0,2857,0,0.925065486347432,0.0,119,2857,fhi:git
county,Agder,2021-01-16,1,0,2858,0,0.925389275457109,0.0,1,2858,fhi:git
county,Agder,2021-01-17,2,0,2860,0,0.926036853676463,0.0,2,2860,fhi:git
county,Agder,2021-01-18,15,0,2875,0,0.93089369032162,0.0,15,2875,fhi:git
county,Agder,2021-01-19,347,0,3222,0,1.04324851137957,0.0,347,3222,fhi:git
county,Agder,2021-01-20,460,0,3682,0,1.19219150183103,0.0,460,3682,fhi:git
county,Agder,2021-01-21,337,0,4019,0,1.30130843179221,0.0,337,4019,fhi:git
county,Agder,2021-01-22,68,0,4087,0,1.32332609125025,0.0,68,4087,fhi:git
county,Agder,2021-01-23,2,0,4089,0,1.3239736694696003,0.0,2,4089,fhi:git
county,Agder,2021-01-24,0,0,4089,0,1.3239736694696003,0.0,0,4089,fhi:git
county,Agder,2021-01-25,3,0,4092,0,1.32494503679863,0.0,3,4092,fhi:git
county,Agder,2021-01-26,63,66,4155,66,1.34534375070829,0.0213700812386876,129,4221,fhi:git
county,Agder,2021-01-27,567,681,4722,747,1.5289321758952001,0.24187046492878303,1248,5469,fhi:git
county,Agder,2021-01-28,952,248,5674,995,1.83717940830778,0.32217016412870003,1200,6669,fhi:git
county,Agder,2021-01-29,204,61,5878,1056,1.9032323866819099,0.341921299819002,265,6934,fhi:git
county,Agder,2021-01-30,32,0,5910,1056,1.9135936381915701,0.341921299819002,32,6966,fhi:git
county,Agder,2021-01-31,24,0,5934,1056,1.9213645768238201,0.341921299819002,24,6990,fhi:git
county,Agder,2021-02-01,1,2,5935,1058,1.9216883659335,0.342568878038356,3,6993,fhi:git
county,Agder,2021-02-02,203,170,6138,1228,1.98741755519795,0.397613026683461,373,7366,fhi:git
county,Agder,2021-02-03,1331,593,7469,1821,2.41838086017815,0.5896199687219721,1924,9290,fhi:git
county,Agder,2021-02-04,1707,497,9176,2318,2.97108887039693,0.7505431562314829,2204,11494,fhi:git
county,Agder,2021-02-05,619,135,9795,2453,3.17151432928705,0.7942546860378901,754,12248,fhi:git
county,Agder,2021-02-06,512,2,10307,2455,3.33729435344172,0.794902264257244,514,12762,fhi:git
county,Agder,2021-02-07,83,2,10390,2457,3.3641688495449102,0.795549842476598,85,12847,fhi:git
county,Agder,2021-02-08,13,2,10403,2459,3.36837810797072,0.796197420695952,15,12862,fhi:git
county,Agder,2021-02-09,189,255,10592,2714,3.42957424969969,0.878763643663609,444,13306,fhi:git
county,Agder,2021-02-10,1152,371,11744,3085,3.80257930404769,0.9988894033538079,1523,14829,fhi:git
county,Agder,2021-02-11,1009,409,12753,3494,4.12928251571187,1.13131914921174,1418,16247,fhi:git
county,Agder,2021-02-12,355,70,13108,3564,4.24422764964723,1.15398438688913,425,16672,fhi:git
county,Agder,2021-02-13,509,3,13617,3567,4.40903630647287,1.1549557542181599,512,17184,fhi:git
county,Agder,2021-02-14,0,0,13617,3567,4.40903630647287,1.1549557542181599,0,17184,fhi:git
county,Agder,2021-02-15,1,1,13618,3568,4.409360095582549,1.1552795433278402,2,17186,fhi:git
county,Agder,2021-02-16,141,116,13759,3684,4.455014360047009,1.1928390800503799,257,17443,fhi:git
county,Agder,2021-02-17,1218,435,14977,4119,4.849389495633701,1.3336873427599099,1653,19096,fhi:git
county,Agder,2021-02-18,1089,820,16066,4939,5.20199583607205,1.59919441269512,1909,21005,fhi:git
county,Agder,2021-02-19,721,343,16787,5282,5.435447784149231,1.7102540773143602,1064,22069,fhi:git
county,Agder,2021-02-20,353,37,17140,5319,5.54974533986524,1.72223427437242,390,22459,fhi:git
county,Agder,2021-02-21,52,23,17192,5342,5.56658237356845,1.72968142389499,75,22534,fhi:git
county,Agder,2021-02-22,224,1,17416,5343,5.639111134136111,1.73000521300467,225,22759,fhi:git
county,Agder,2021-02-23,294,201,17710,5544,5.734305132381179,1.7950868240497602,495,23254,fhi:git
county,Agder,2021-02-24,976,1110,18686,6654,6.050323303426009,2.15449273579132,2086,25340,fhi:git
county,Agder,2021-02-25,718,1564,19404,8218,6.28280388417416,2.6608989033262898,2282,27622,fhi:git
county,Agder,2021-02-26,398,466,19802,8684,6.41167194982564,2.8117846284358103,864,28486,fhi:git
county,Agder,2021-02-27,0,1,19802,8685,6.41167194982564,2.8121084175454802,1,28487,fhi:git
county,Agder,2021-02-28,10,82,19812,8767,6.414909840922411,2.83865912453901,92,28579,fhi:git
county,Agder,2021-03-01,261,0,20073,8767,6.49941879854813,2.83865912453901,261,28840,fhi:git
county,Agder,2021-03-02,579,192,20652,8959,6.686892693051161,2.90082663359701,771,29611,fhi:git
county,Agder,2021-03-03,634,878,21286,9837,6.89217498858644,3.18511347189349,1512,31123,fhi:git
county,Agder,2021-03-04,796,1068,22082,10905,7.149911119889389,3.53092024102861,1864,32987,fhi:git
county,Agder,2021-03-05,958,368,23040,11273,7.46010108696004,3.6500746333897798,1326,34313,fhi:git
county,Agder,2021-03-06,36,405,23076,11678,7.47175749490842,3.781209222809,441,34754,fhi:git
county,Agder,2021-03-07,3,0,23079,11678,7.4727288622374495,3.781209222809,3,34757,fhi:git
county,Agder,2021-03-08,226,0,23305,11678,7.545905201024469,3.781209222809,226,34983,fhi:git
county,Agder,2021-03-09,722,141,24027,11819,7.779680938211321,3.8268634872734704,863,35846,fhi:git
county,Agder,2021-03-10,1031,784,25058,12603,8.1135075102884,4.0807141492603,1815,37661,fhi:git
county,Agder,2021-03-11,645,813,25703,13416,8.32235148603012,4.34395469542777,1458,39119,fhi:git
county,Agder,2021-03-12,97,323,25800,13739,8.3537590296688,4.44853857785347,420,39539,fhi:git
county,Agder,2021-03-13,0,0,25800,13739,8.3537590296688,4.44853857785347,0,39539,fhi:git
county,Agder,2021-03-14,0,0,25800,13739,8.3537590296688,4.44853857785347,0,39539,fhi:git
county,Agder,2021-03-15,0,3,25800,13742,8.3537590296688,4.4495099451825,3,39542,fhi:git
county,Agder,2021-03-16,239,14,26039,13756,8.43114462688162,4.454042992717981,253,39795,fhi:git
county,Agder,2021-03-17,1605,47,27644,13803,8.95082614791334,4.469261080872809,1652,41447,fhi:git
county,Agder,2021-03-18,1247,89,28891,13892,9.35459116768067,4.49807831163407,1336,42783,fhi:git
county,Agder,2021-03-19,264,40,29155,13932,9.44007149263542,4.5110298760211505,304,43087,fhi:git
county,Agder,2021-03-20,0,0,29155,13932,9.44007149263542,4.5110298760211505,0,43087,fhi:git
county,Agder,2021-03-21,17,53,29172,13985,9.44557590749993,4.52819069883404,70,43157,fhi:git
county,Agder,2021-03-22,9,1,29181,13986,9.44849000948702,4.52851448794371,10,43167,fhi:git
county,Agder,2021-03-23,302,14,29483,14000,9.5462743206095,4.533047535479191,316,43483,fhi:git
county,Innlandet,2020-12-27,0,0,0,0,0.0,0.0,0,0,fhi:git
county,Innlandet,2020-12-28,272,0,272,0,0.0732393607711674,0.0,272,272,fhi:git
county,Innlandet,2020-12-29,260,0,532,0,0.143247573273019,0.0,260,532,fhi:git
county,Innlandet,2020-12-30,149,0,681,0,0.183367664283695,0.0,149,681,fhi:git
county,Innlandet,2020-12-31,0,0,681,0,0.183367664283695,0.0,0,681,fhi:git
county,Innlandet,2021-01-01,0,0,681,0,0.183367664283695,0.0,0,681,fhi:git
county,Innlandet,2021-01-02,0,0,681,0,0.183367664283695,0.0,0,681,fhi:git
county,Innlandet,2021-01-03,0,0,681,0,0.183367664283695,0.0,0,681,fhi:git
county,Innlandet,2021-01-04,0,0,681,0,0.18375458374594897,0.0,0,681,fhi:git
county,Innlandet,2021-01-05,271,0,952,0,0.256878654517098,0.0,271,952,fhi:git
county,Innlandet,2021-01-06,703,0,1655,0,0.44656950969096293,0.0,703,1655,fhi:git
county,Innlandet,2021-01-07,696,0,2351,0,0.634371551228673,0.0,696,2351,fhi:git
county,Innlandet,2021-01-08,75,0,2426,0,0.654608840187478,0.0,75,2426,fhi:git
county,Innlandet,2021-01-09,0,0,2426,0,0.654608840187478,0.0,0,2426,fhi:git
county,Innlandet,2021-01-10,0,0,2426,0,0.654608840187478,0.0,0,2426,fhi:git
county,Innlandet,2021-01-11,50,0,2476,0,0.668100366160015,0.0,50,2476,fhi:git
county,Innlandet,2021-01-12,403,0,2879,0,0.7768420654986601,0.0,403,2879,fhi:git
county,Innlandet,2021-01-13,994,0,3873,0,1.04505360183269,0.0,994,3873,fhi:git
county,Innlandet,2021-01-14,957,0,4830,0,1.30328140894704,0.0,957,4830,fhi:git
county,Innlandet,2021-01-15,279,0,5109,0,1.3785641238738,0.0,279,5109,fhi:git
county,Innlandet,2021-01-16,4,0,5113,0,1.3796434459516,0.0,4,5113,fhi:git
county,Innlandet,2021-01-17,0,0,5113,0,1.3796434459516,0.0,0,5113,fhi:git
county,Innlandet,2021-01-18,62,0,5175,0,1.39637293815754,0.0,62,5175,fhi:git
county,Innlandet,2021-01-19,331,318,5506,318,1.48568684009574,0.0858061051853331,649,5824,fhi:git
county,Innlandet,2021-01-20,663,252,6169,570,1.66458447449157,0.153803396086918,915,6739,fhi:git
county,Innlandet,2021-01-21,833,48,7002,618,1.88935329719403,0.166755261020553,881,7620,fhi:git
county,Innlandet,2021-01-22,239,0,7241,618,1.95384279134276,0.166755261020553,239,7859,fhi:git
county,Innlandet,2021-01-23,6,0,7247,618,1.95546177445946,0.166755261020553,6,7865,fhi:git
county,Innlandet,2021-01-24,0,0,7247,618,1.95546177445946,0.166755261020553,0,7865,fhi:git
county,Innlandet,2021-01-25,1,0,7248,618,1.9557316049789097,0.166755261020553,1,7866,fhi:git
county,Innlandet,2021-01-26,152,131,7400,749,1.99674584393542,0.20210305906859902,283,8149,fhi:git
county,Innlandet,2021-01-27,934,604,8334,1353,2.24876754910241,0.365080692816842,1538,9687,fhi:git
county,Innlandet,2021-01-28,904,708,9238,2061,2.49269433868587,0.556120700587961,1612,11299,fhi:git
county,Innlandet,2021-01-29,319,132,9557,2193,2.5787702743906604,0.591738329155457,451,11750,fhi:git
county,Innlandet,2021-01-30,2,0,9559,2193,2.57930993542956,0.591738329155457,2,11752,fhi:git
county,Innlandet,2021-01-31,1,0,9560,2193,2.57957976594901,0.591738329155457,1,11753,fhi:git
county,Innlandet,2021-02-01,9,49,9569,2242,2.58200824062406,0.604960024608543,58,11811,fhi:git
county,Innlandet,2021-02-02,610,341,10179,2583,2.7466048574890096,0.6969722317412429,951,12762,fhi:git
county,Innlandet,2021-02-03,2310,873,12489,3456,3.3699133574202,0.9325342752217328,3183,15945,fhi:git
county,Innlandet,2021-02-04,2656,997,15145,4453,4.08658321708135,1.2015553031141102,3653,19598,fhi:git
county,Innlandet,2021-02-05,814,270,15959,4723,4.30622525991425,1.27440954336581,1084,20682,fhi:git
county,Innlandet,2021-02-06,7,4,15966,4727,4.3081140735504,1.27548886544361,11,20693,fhi:git
county,Innlandet,2021-02-07,0,0,15966,4727,4.3081140735504,1.27548886544361,0,20693,fhi:git
county,Innlandet,2021-02-08,2,62,15968,4789,4.308653734589299,1.29221835764956,64,20757,fhi:git
county,Innlandet,2021-02-09,257,269,16225,5058,4.37800017808814,1.36480276738181,526,21283,fhi:git
county,Innlandet,2021-02-10,2055,589,18280,5647,4.9325018955594,1.5237329433382902,2644,23927,fhi:git
county,Innlandet,2021-02-11,2238,848,20518,6495,5.53638259809014,1.7525492238325102,3086,27013,fhi:git
county,Innlandet,2021-02-12,430,283,20948,6778,5.65240972145396,1.8289112608370701,713,27726,fhi:git
county,Innlandet,2021-02-13,0,5,20948,6783,5.65240972145396,1.83026041343432,5,27731,fhi:git
county,Innlandet,2021-02-14,1,0,20949,6783,5.652679551973409,1.83026041343432,1,27732,fhi:git
county,Innlandet,2021-02-15,87,14,21036,6797,5.67615480716562,1.8340380407066297,101,27833,fhi:git
county,Innlandet,2021-02-16,530,92,21566,6889,5.8191649824745095,1.8588624484961,622,28455,fhi:git
county,Innlandet,2021-02-17,1573,782,23139,7671,6.243608389570509,2.0698699147065702,2355,30810,fhi:git
county,Innlandet,2021-02-18,1467,902,24606,8573,6.639449761604741,2.31325704325113,2369,33179,fhi:git
county,Innlandet,2021-02-19,541,296,25147,8869,6.78542807262758,2.39312687700855,837,34016,fhi:git
county,Innlandet,2021-02-20,0,3,25147,8872,6.78542807262758,2.3939363685668997,3,34019,fhi:git
county,Innlandet,2021-02-21,0,1,25147,8873,6.78542807262758,2.39420619908635,1,34020,fhi:git
county,Innlandet,2021-02-22,283,3,25430,8876,6.861790109632139,2.39501569064471,286,34306,fhi:git
county,Innlandet,2021-02-23,319,306,25749,9182,6.94786604533692,2.4775838295966297,625,34931,fhi:git
county,Innlandet,2021-02-24,849,2319,26598,11501,7.176952156350599,3.1033208042028795,3168,38099,fhi:git
county,Innlandet,2021-02-25,1747,2448,28345,13949,7.64834607383103,3.7638659158182697,4195,42294,fhi:git
county,Innlandet,2021-02-26,677,813,29022,14762,7.83102133549917,3.9832381281317204,1490,43784,fhi:git
county,Innlandet,2021-02-27,3,1,29025,14763,7.83183082705753,3.9835079586511704,4,43788,fhi:git
county,Innlandet,2021-02-28,3,6,29028,14769,7.83264031861588,3.98512694176788,9,43797,fhi:git
county,Innlandet,2021-03-01,190,7,29218,14776,7.8839081173115195,3.9870157554040295,197,43994,fhi:git
county,Innlandet,2021-03-02,526,159,29744,14935,8.0258389705426,4.0299188079967,685,44679,fhi:git
county,Innlandet,2021-03-03,1596,1970,31340,16905,8.45648847958597,4.56148493131464,3566,48245,fhi:git
county,Innlandet,2021-03-04,1515,2264,32855,19169,8.86528171655383,5.1723812273511,3779,52024,fhi:git
county,Innlandet,2021-03-05,548,421,33403,19590,9.01314884121283,5.28597987603986,969,52993,fhi:git
county,Innlandet,2021-03-06,2,3,33405,19593,9.01368850225174,5.28678936759821,5,52998,fhi:git
county,Innlandet,2021-03-07,0,0,33405,19593,9.01368850225174,5.28678936759821,0,52998,fhi:git
county,Innlandet,2021-03-08,113,0,33518,19593,9.04417935094967,5.28678936759821,113,53111,fhi:git
county,Innlandet,2021-03-09,936,311,34454,19904,9.29674071715555,5.37070665914739,1247,54358,fhi:git
county,Innlandet,2021-03-10,2023,1307,36477,21211,9.84260785800439,5.7233751480695,3330,57688,fhi:git
county,Innlandet,2021-03-11,1013,968,37490,22179,10.115946174208,5.984571090897809,1981,59669,fhi:git
county,Innlandet,2021-03-12,43,178,37533,22357,10.1275488865444,6.03260092336004,221,59890,fhi:git
county,Innlandet,2021-03-13,0,0,37533,22357,10.1275488865444,6.03260092336004,0,59890,fhi:git
county,Innlandet,2021-03-14,0,1,37533,22358,10.1275488865444,6.0328707538794895,1,59891,fhi:git
county,Innlandet,2021-03-15,25,3,37558,22361,10.134294649530599,6.03368024543784,28,59919,fhi:git
county,Innlandet,2021-03-16,360,9,37918,22370,10.2314336365329,6.0361087201129004,369,60288,fhi:git
county,Innlandet,2021-03-17,1795,152,39713,22522,10.715779418947001,6.077122959069411,1947,62235,fhi:git
county,Innlandet,2021-03-18,1650,98,41363,22620,11.160999776040699,6.10356634997558,1748,63983,fhi:git
county,Innlandet,2021-03-19,187,20,41550,22640,11.211458083178,6.108962960364599,207,64190,fhi:git
county,Innlandet,2021-03-20,0,0,41550,22640,11.211458083178,6.108962960364599,0,64190,fhi:git
county,Innlandet,2021-03-21,1,0,41551,22640,11.2117279136974,6.108962960364599,1,64191,fhi:git
county,Innlandet,2021-03-22,98,7,41649,22647,11.2381713046036,6.11085177400075,105,64296,fhi:git
county,Innlandet,2021-03-23,805,51,42454,22698,11.4553848727614,6.124613130492739,856,65152,fhi:git
county,Møre og Romsdal,2020-12-27,0,0,0,0,0.0,0.0,0,0,fhi:git
county,Møre og Romsdal,2020-12-28,0,0,0,0,0.0,0.0,0,0,fhi:git
county,Møre og Romsdal,2020-12-29,0,0,0,0,0.0,0.0,0,0,fhi:git
county,Møre og Romsdal,2020-12-30,0,0,0,0,0.0,0.0,0,0,fhi:git
county,Møre og Romsdal,2020-12-31,0,0,0,0,0.0,0.0,0,0,fhi:git
county,Møre og Romsdal,2021-01-01,0,0,0,0,0.0,0.0,0,0,fhi:git
county,Møre og Romsdal,2021-01-02,0,0,0,0,0.0,0.0,0,0,fhi:git
county,Møre og Romsdal,2021-01-03,0,0,0,0,0.0,0.0,0,0,fhi:git
county,Møre og Romsdal,2021-01-04,0,0,0,0,0.0,0.0,0,0,fhi:git
county,Møre og Romsdal,2021-01-05,186,0,186,0,0.0700448889826168,0.0,186,186,fhi:git
county,Møre og Romsdal,2021-01-06,497,0,683,0,0.257207845027566,0.0,497,683,fhi:git
county,Møre og Romsdal,2021-01-07,457,0,1140,0,0.4293073840870061,0.0,457,1140,fhi:git
county,Møre og Romsdal,2021-01-08,36,0,1176,0,0.442864459373964,0.0,36,1176,fhi:git
county,Møre og Romsdal,2021-01-09,1,0,1177,0,0.443241044798602,0.0,1,1177,fhi:git
county,Møre og Romsdal,2021-01-10,0,0,1177,0,0.443241044798602,0.0,0,1177,fhi:git
county,Møre og Romsdal,2021-01-11,1,0,1178,0,0.44361763022323997,0.0,1,1178,fhi:git
county,Møre og Romsdal,2021-01-12,225,0,1403,0,0.528349350766728,0.0,225,1403,fhi:git
county,Møre og Romsdal,2021-01-13,387,0,1790,0,0.674087910101528,0.0,387,1790,fhi:git
county,Møre og Romsdal,2021-01-14,410,0,2200,0,0.828487934202995,0.0,410,2200,fhi:git
county,Møre og Romsdal,2021-01-15,151,0,2351,0,0.885352333323291,0.0,151,2351,fhi:git
county,Møre og Romsdal,2021-01-16,1,0,2352,0,0.885728918747929,0.0,1,2352,fhi:git
county,Møre og Romsdal,2021-01-17,2,0,2354,0,0.886482089597204,0.0,2,2354,fhi:git
county,Møre og Romsdal,2021-01-18,11,0,2365,0,0.8906245292682192,0.0,11,2365,fhi:git
county,Møre og Romsdal,2021-01-19,203,0,2568,0,0.967071370469677,0.0,203,2568,fhi:git
county,Møre og Romsdal,2021-01-20,500,0,3068,0,1.15536408278854,0.0,500,3068,fhi:git
county,Møre og Romsdal,2021-01-21,800,0,3868,0,1.45663242249872,0.0,800,3868,fhi:git
county,Møre og Romsdal,2021-01-22,212,0,4080,0,1.5364685325219198,0.0,212,4080,fhi:git
county,Møre og Romsdal,2021-01-23,0,0,4080,0,1.5364685325219198,0.0,0,4080,fhi:git
county,Møre og Romsdal,2021-01-24,0,0,4080,0,1.5364685325219198,0.0,0,4080,fhi:git
county,Møre og Romsdal,2021-01-25,3,0,4083,0,1.53759828879583,0.0,3,4083,fhi:git
county,Møre og Romsdal,2021-01-26,78,129,4161,129,1.56697195191757,0.0485795197782665,207,4290,fhi:git
county,Møre og Romsdal,2021-01-27,543,359,4704,488,1.77145783749586,0.18377368722321,902,5192,fhi:git
county,Møre og Romsdal,2021-01-28,493,509,5197,997,1.95711445184226,0.37545566836381206,1002,6194,fhi:git
county,Møre og Romsdal,2021-01-29,99,78,5296,1075,1.9943964088813897,0.404829331485554,177,6371,fhi:git
county,Møre og Romsdal,2021-01-30,0,1,5296,1076,1.9943964088813897,0.405205916910192,1,6372,fhi:git
county,Møre og Romsdal,2021-01-31,0,0,5296,1076,1.9943964088813897,0.405205916910192,0,6372,fhi:git
county,Møre og Romsdal,2021-02-01,0,0,5296,1076,1.9943964088813897,0.405205916910192,0,6372,fhi:git
county,Møre og Romsdal,2021-02-02,291,193,5587,1269,2.10398276745097,0.47788690386527294,484,6856,fhi:git
county,Møre og Romsdal,2021-02-03,1063,312,6650,1581,2.5042930738408704,0.5953815563522429,1375,8231,fhi:git
county,Møre og Romsdal,2021-02-04,1545,463,8195,2044,3.0861175549061604,0.7697406079595099,2008,10239,fhi:git
county,Møre og Romsdal,2021-02-05,219,155,8414,2199,3.16858976290182,0.828111348778357,374,10613,fhi:git
county,Møre og Romsdal,2021-02-06,1,2,8415,2201,3.16896634832645,0.8288645196276321,3,10616,fhi:git
county,Møre og Romsdal,2021-02-07,0,1,8415,2202,3.16896634832645,0.82924110505227,1,10617,fhi:git
county,Møre og Romsdal,2021-02-08,1,2,8416,2204,3.1693429337510897,0.8299942759015458,3,10620,fhi:git
county,Møre og Romsdal,2021-02-09,326,183,8742,2387,3.2921097821829903,0.898909408610249,509,11129,fhi:git
county,Møre og Romsdal,2021-02-10,1258,435,10000,2822,3.7658542463772497,1.06272406832766,1693,12822,fhi:git
county,Møre og Romsdal,2021-02-11,1254,804,11254,3626,4.238092368872961,1.3654987497363897,2058,14880,fhi:git
county,Møre og Romsdal,2021-02-12,295,207,11549,3833,4.34918506914108,1.4434519326364,502,15382,fhi:git
county,Møre og Romsdal,2021-02-13,24,0,11573,3833,4.358223119332391,1.4434519326364,24,15406,fhi:git
county,Møre og Romsdal,2021-02-14,0,0,11573,3833,4.358223119332391,1.4434519326364,0,15406,fhi:git
county,Møre og Romsdal,2021-02-15,1,8,11574,3841,4.35859970475703,1.4464646160335002,9,15415,fhi:git
county,Møre og Romsdal,2021-02-16,353,58,11927,3899,4.49153435965414,1.46830657066249,411,15826,fhi:git
county,Møre og Romsdal,2021-02-17,1204,424,13131,4323,4.94494321091796,1.6279787907088799,1628,17454,fhi:git
county,Møre og Romsdal,2021-02-18,1166,522,14297,4845,5.38404181604555,1.82455638236978,1688,19142,fhi:git
county,Møre og Romsdal,2021-02-19,499,94,14796,4939,5.57195794293978,1.85995541228572,593,19735,fhi:git
county,Møre og Romsdal,2021-02-20,11,0,14807,4939,5.5761003826107896,1.85995541228572,11,19746,fhi:git
county,Møre og Romsdal,2021-02-21,0,0,14807,4939,5.5761003826107896,1.85995541228572,0,19746,fhi:git
county,Møre og Romsdal,2021-02-22,15,0,14822,4939,5.58174916398036,1.85995541228572,15,19761,fhi:git
county,Møre og Romsdal,2021-02-23,390,223,15212,5162,5.72861747958907,1.9439339619799398,613,20374,fhi:git
county,Møre og Romsdal,2021-02-24,729,875,15941,6037,6.00314825414997,2.27344620853794,1604,21978,fhi:git
county,Møre og Romsdal,2021-02-25,704,1469,16645,7506,6.268264393094929,2.8266501973307596,2173,24151,fhi:git
county,Møre og Romsdal,2021-02-26,260,203,16905,7709,6.36617660350074,2.9030970385322203,463,24614,fhi:git
county,Møre og Romsdal,2021-02-27,2,1,16907,7710,6.36692977435001,2.90347362395686,3,24617,fhi:git
county,Møre og Romsdal,2021-02-28,0,0,16907,7710,6.36692977435001,2.90347362395686,0,24617,fhi:git
county,Møre og Romsdal,2021-03-01,100,1,17007,7711,6.40458831681379,2.9038502093815,101,24718,fhi:git
county,Møre og Romsdal,2021-03-02,742,251,17749,7962,6.684014701894981,2.9983731509655698,993,25711,fhi:git
county,Møre og Romsdal,2021-03-03,869,1116,18618,9078,7.01126743590516,3.41864248486127,1985,27696,fhi:git
county,Møre og Romsdal,2021-03-04,988,1304,19606,10382,7.38333383544723,3.90970987858886,2292,29988,fhi:git
county,Møre og Romsdal,2021-03-05,816,274,20422,10656,7.690627541951621,4.0128942849396,1090,31078,fhi:git
county,Møre og Romsdal,2021-03-06,3,6,20425,10662,7.6917572982255304,4.01515379748742,9,31087,fhi:git
county,Møre og Romsdal,2021-03-07,0,0,20425,10662,7.6917572982255304,4.01515379748742,0,31087,fhi:git
county,Møre og Romsdal,2021-03-08,157,0,20582,10662,7.75088120989365,4.01515379748742,157,31244,fhi:git
county,Møre og Romsdal,2021-03-09,669,238,21251,10900,8.00281685897629,4.1047811285512,907,32151,fhi:git
county,Møre og Romsdal,2021-03-10,1285,944,22536,11844,8.48672912963577,4.46027776940921,2229,34380,fhi:git
county,Møre og Romsdal,2021-03-11,539,973,23075,12817,8.6897086735155,4.82669538758172,1512,35892,fhi:git
county,Møre og Romsdal,2021-03-12,67,248,23142,13065,8.71493989696623,4.92008857289187,315,36207,fhi:git
county,Møre og Romsdal,2021-03-13,0,16,23142,13081,8.71493989696623,4.92611393968608,16,36223,fhi:git
county,Møre og Romsdal,2021-03-14,0,0,23142,13081,8.71493989696623,4.92611393968608,0,36223,fhi:git
county,Møre og Romsdal,2021-03-15,0,1,23142,13082,8.71493989696623,4.92649052511072,1,36224,fhi:git
county,Møre og Romsdal,2021-03-16,334,10,23476,13092,8.84071942879523,4.93025637935709,344,36568,fhi:git
county,Møre og Romsdal,2021-03-17,1536,128,25012,13220,9.41915464103877,4.97845931371072,1664,38232,fhi:git
county,Møre og Romsdal,2021-03-18,1485,59,26497,13279,9.978383996625789,5.0006778537643495,1544,39776,fhi:git
county,Møre og Romsdal,2021-03-19,205,37,26702,13316,10.055584008676501,5.0146115144759404,242,40018,fhi:git
county,Møre og Romsdal,2021-03-20,18,0,26720,13316,10.06236254632,5.0146115144759404,18,40036,fhi:git
county,Møre og Romsdal,2021-03-21,0,0,26720,13316,10.06236254632,5.0146115144759404,0,40036,fhi:git
county,Møre og Romsdal,2021-03-22,1,1,26721,13317,10.0627391317446,5.01498809990058,2,40038,fhi:git
county,Møre og Romsdal,2021-03-23,557,13,27278,13330,10.2724972132679,5.01988371042087,570,40608,fhi:git
county,Nordland,2020-12-27,0,0,0,0,0.0,0.0,0,0,fhi:git
county,Nordland,2020-12-28,0,0,0,0,0.0,0.0,0,0,fhi:git
county,Nordland,2020-12-29,0,0,0,0,0.0,0.0,0,0,fhi:git
county,Nordland,2020-12-30,1,0,1,0,0.00041453354612722,0.0,1,1,fhi:git
county,Nordland,2020-12-31,0,0,1,0,0.00041453354612722,0.0,0,1,fhi:git
county,Nordland,2021-01-01,0,0,1,0,0.00041453354612722,0.0,0,1,fhi:git
county,Nordland,2021-01-02,0,0,1,0,0.00041453354612722,0.0,0,1,fhi:git
county,Nordland,2021-01-03,0,0,1,0,0.00041453354612722,0.0,0,1,fhi:git
county,Nordland,2021-01-04,0,0,1,0,0.000416068568100023,0.0,0,1,fhi:git
county,Nordland,2021-01-05,200,0,201,0,0.0836297821881046,0.0,200,201,fhi:git
county,Nordland,2021-01-06,686,0,887,0,0.36905281990471994,0.0,686,887,fhi:git
county,Nordland,2021-01-07,238,0,1125,0,0.468077139112526,0.0,238,1125,fhi:git
county,Nordland,2021-01-08,114,0,1239,0,0.5155089558759279,0.0,114,1239,fhi:git
county,Nordland,2021-01-09,0,0,1239,0,0.5155089558759279,0.0,0,1239,fhi:git
county,Nordland,2021-01-10,0,0,1239,0,0.5155089558759279,0.0,0,1239,fhi:git
county,Nordland,2021-01-11,0,0,1239,0,0.5155089558759279,0.0,0,1239,fhi:git
county,Nordland,2021-01-12,292,0,1531,0,0.6370009777611351,0.0,292,1531,fhi:git
county,Nordland,2021-01-13,626,0,2157,0,0.8974599013917491,0.0,626,2157,fhi:git
county,Nordland,2021-01-14,272,0,2429,0,1.01063055191496,0.0,272,2429,fhi:git
county,Nordland,2021-01-15,69,0,2498,0,1.0393392831138601,0.0,69,2498,fhi:git
county,Nordland,2021-01-16,0,0,2498,0,1.0393392831138601,0.0,0,2498,fhi:git
county,Nordland,2021-01-17,1,0,2499,0,1.03975535168196,0.0,1,2499,fhi:git
county,Nordland,2021-01-18,0,0,2499,0,1.03975535168196,0.0,0,2499,fhi:git
county,Nordland,2021-01-19,313,0,2812,0,1.1699848134972601,0.0,313,2812,fhi:git
county,Nordland,2021-01-20,786,0,3598,0,1.4970147080238798,0.0,786,3598,fhi:git
county,Nordland,2021-01-21,616,0,4214,0,1.7533129459735,0.0,616,4214,fhi:git
county,Nordland,2021-01-22,173,0,4387,0,1.8252928082548001,0.0,173,4387,fhi:git
county,Nordland,2021-01-23,4,0,4391,0,1.8269570825272,0.0,4,4391,fhi:git
county,Nordland,2021-01-24,0,0,4391,0,1.8269570825272,0.0,0,4391,fhi:git
county,Nordland,2021-01-25,51,0,4442,0,1.8481765795003,0.0,51,4442,fhi:git
county,Nordland,2021-01-26,119,90,4561,90,1.8976887391042,0.0374461711290021,209,4651,fhi:git
county,Nordland,2021-01-27,626,528,5187,618,2.15814766273482,0.257130375085814,1154,5805,fhi:git
county,Nordland,2021-01-28,471,365,5658,983,2.3541159583099303,0.40899540244232296,836,6641,fhi:git
county,Nordland,2021-01-29,211,144,5869,1127,2.4419064261790298,0.468909276248726,355,6996,fhi:git
county,Nordland,2021-01-30,1,0,5870,1127,2.44232249474713,0.468909276248726,1,6997,fhi:git
county,Nordland,2021-01-31,0,0,5870,1127,2.44232249474713,0.468909276248726,0,6997,fhi:git
county,Nordland,2021-02-01,9,4,5879,1131,2.44606711186003,0.47057355052112604,13,7010,fhi:git
county,Nordland,2021-02-02,111,200,5990,1331,2.49225072291914,0.553787264141131,311,7321,fhi:git
county,Nordland,2021-02-03,1419,456,7409,1787,3.08265202105307,0.743514531194741,1875,9196,fhi:git
county,Nordland,2021-02-04,1670,346,9079,2133,3.77748652978011,0.8874742557573492,2016,11212,fhi:git
county,Nordland,2021-02-05,329,155,9408,2288,3.91437308868502,0.951964883812852,484,11696,fhi:git
county,Nordland,2021-02-06,0,0,9408,2288,3.91437308868502,0.951964883812852,0,11696,fhi:git
county,Nordland,2021-02-07,1,0,9409,2288,3.91478915725312,0.951964883812852,1,11697,fhi:git
county,Nordland,2021-02-08,7,1,9416,2289,3.9177016372298197,0.9523809523809521,8,11705,fhi:git
county,Nordland,2021-02-09,70,262,9486,2551,3.94682643699682,1.06139091722316,332,12037,fhi:git
county,Nordland,2021-02-10,2030,633,11516,3184,4.791445630239861,1.32476232083047,2663,14700,fhi:git
county,Nordland,2021-02-11,1221,583,12737,3767,5.29946535188999,1.56733029603279,1804,16504,fhi:git
county,Nordland,2021-02-12,287,238,13024,4005,5.418877030934699,1.66635461524059,525,17029,fhi:git
county,Nordland,2021-02-13,53,3,13077,4008,5.440928665044,1.6676028209448899,56,17085,fhi:git
county,Nordland,2021-02-14,0,0,13077,4008,5.440928665044,1.6676028209448899,0,17085,fhi:git
county,Nordland,2021-02-15,0,1,13077,4009,5.440928665044,1.6680188895129902,1,17086,fhi:git
county,Nordland,2021-02-16,223,71,13300,4080,5.5337119557303,1.6975597578480903,294,17380,fhi:git
county,Nordland,2021-02-17,1490,515,14790,4595,6.15365412219934,1.91183507041961,2005,19385,fhi:git
county,Nordland,2021-02-18,849,607,15639,5202,6.5068963365162595,2.1643886912563204,1456,20841,fhi:git
county,Nordland,2021-02-19,306,230,15945,5432,6.63421331835487,2.26008446191932,536,21377,fhi:git
county,Nordland,2021-02-20,1,1,15946,5433,6.6346293869229696,2.26050053048742,2,21379,fhi:git
county,Nordland,2021-02-21,0,0,15946,5433,6.6346293869229696,2.26050053048742,0,21379,fhi:git
county,Nordland,2021-02-22,270,0,16216,5433,6.746967900309969,2.26050053048742,270,21649,fhi:git
county,Nordland,2021-02-23,307,56,16523,5489,6.874700950716679,2.2838003703010297,363,22012,fhi:git
county,Nordland,2021-02-24,973,1008,17496,6497,7.279535667478,2.70319748694585,1981,23993,fhi:git
county,Nordland,2021-02-25,590,1849,18086,8346,7.525016122657009,3.47250826936279,2439,26432,fhi:git
county,Nordland,2021-02-26,423,397,18509,8743,7.7010131269633195,3.6376874908985,820,27252,fhi:git
county,Nordland,2021-02-27,1,4,18510,8747,7.70142919553142,3.6393517651708995,5,27257,fhi:git
county,Nordland,2021-02-28,0,1,18510,8748,7.70142919553142,3.639767833739,1,27258,fhi:git
county,Nordland,2021-03-01,240,0,18750,8748,7.801285651875429,3.639767833739,240,27498,fhi:git
county,Nordland,2021-03-02,516,50,19266,8798,8.01597703301504,3.660571262144,566,28064,fhi:git
county,Nordland,2021-03-03,621,1582,19887,10380,8.274355613805161,4.31879173687824,2203,30267,fhi:git
county,Nordland,2021-03-04,718,1365,20605,11745,8.57309284570097,4.88672533233477,2083,32350,fhi:git
county,Nordland,2021-03-05,440,339,21045,12084,8.756163015664981,5.02777257692068,779,33129,fhi:git
county,Nordland,2021-03-06,13,51,21058,12135,8.76157190705028,5.04899207389378,64,33193,fhi:git
county,Nordland,2021-03-07,0,0,21058,12135,8.76157190705028,5.04899207389378,0,33193,fhi:git
county,Nordland,2021-03-08,360,0,21418,12135,8.911356591566289,5.04899207389378,360,33553,fhi:git
county,Nordland,2021-03-09,651,51,22069,12186,9.1822172293994,5.07021157086688,702,34255,fhi:git
county,Nordland,2021-03-10,1195,1179,23264,13365,9.67941916827893,5.560756412656809,2374,36629,fhi:git
county,Nordland,2021-03-11,729,989,23993,14354,9.98273315442385,5.97224822650773,1718,38347,fhi:git
county,Nordland,2021-03-12,70,252,24063,14606,10.0118579541909,6.07709750566893,322,38669,fhi:git
county,Nordland,2021-03-13,3,2,24066,14608,10.0131061598952,6.077929642805129,5,38674,fhi:git
county,Nordland,2021-03-14,0,0,24066,14608,10.0131061598952,6.077929642805129,0,38674,fhi:git
county,Nordland,2021-03-15,0,1,24066,14609,10.0131061598952,6.07834571137324,1,38675,fhi:git
county,Nordland,2021-03-16,118,5,24184,14614,10.062202250931,6.0804260542137305,123,38798,fhi:git
county,Nordland,2021-03-17,902,64,25086,14678,10.4374960993572,6.10705444257214,966,39764,fhi:git
county,Nordland,2021-03-18,1159,73,26245,14751,10.9197195697851,6.13742744804344,1232,40996,fhi:git
county,Nordland,2021-03-19,225,28,26470,14779,11.0133349976076,6.14907736795024,253,41249,fhi:git
county,Nordland,2021-03-20,38,0,26508,14779,11.029145603195401,6.14907736795024,38,41287,fhi:git
county,Nordland,2021-03-21,0,0,26508,14779,11.029145603195401,6.14907736795024,0,41287,fhi:git
county,Nordland,2021-03-22,36,2,26544,14781,11.044124071647,6.149909505086439,38,41325,fhi:git
county,Nordland,2021-03-23,559,8,27103,14789,11.2767064012149,6.15323805363124,567,41892,fhi:git
county,Oslo,2020-12-27,5,0,5,0,0.00072098677133472,0.0,5,5,fhi:git
county,Oslo,2020-12-28,264,0,269,0,0.0387890882978079,0.0,264,269,fhi:git
county,Oslo,2020-12-29,118,0,387,0,0.0558043761013073,0.0,118,387,fhi:git
county,Oslo,2020-12-30,58,0,445,0,0.06416782264879001,0.0,58,445,fhi:git
county,Oslo,2020-12-31,5,0,450,0,0.0648888094201248,0.0,5,450,fhi:git
county,Oslo,2021-01-01,6,0,456,0,0.0657539935457264,0.0,6,456,fhi:git
county,Oslo,2021-01-02,0,0,456,0,0.0657539935457264,0.0,0,456,fhi:git
county,Oslo,2021-01-03,0,0,456,0,0.0657539935457264,0.0,0,456,fhi:git
county,Oslo,2021-01-04,0,0,456,0,0.06542230384069099,0.0,0,456,fhi:git
county,Oslo,2021-01-05,479,0,935,0,0.13414441686632902,0.0,479,935,fhi:git
county,Oslo,2021-01-06,604,0,1539,0,0.220800275462332,0.0,604,1539,fhi:git
county,Oslo,2021-01-07,967,0,2506,0,0.359535731194674,0.0,967,2506,fhi:git
county,Oslo,2021-01-08,450,0,2956,0,0.42409721524798794,0.0,450,2956,fhi:git
county,Oslo,2021-01-09,127,0,3083,0,0.44231790074747895,0.0,127,3083,fhi:git
county,Oslo,2021-01-10,100,0,3183,0,0.45666489720377007,0.0,100,3183,fhi:git
county,Oslo,2021-01-11,77,0,3260,0,0.46771208447511503,0.0,77,3260,fhi:git
county,Oslo,2021-01-12,241,0,3501,0,0.502288345934779,0.0,241,3501,fhi:git
county,Oslo,2021-01-13,489,0,3990,0,0.572445158606046,0.0,489,3990,fhi:git
county,Oslo,2021-01-14,1239,0,5229,0,0.7502044446995021,0.0,1239,5229,fhi:git
county,Oslo,2021-01-15,1637,0,6866,0,0.9850647766889999,0.0,1637,6866,fhi:git
county,Oslo,2021-01-16,645,0,7511,0,1.07760290383208,0.0,645,7511,fhi:git
county,Oslo,2021-01-17,276,5,7787,5,1.1172006140514499,0.0007173498228145941,281,7792,fhi:git
county,Oslo,2021-01-18,760,231,8547,236,1.22623778711927,0.0338589116368488,991,8783,fhi:git
county,Oslo,2021-01-19,810,70,9357,306,1.3424484584152299,0.0439018091562531,880,9663,fhi:git
county,Oslo,2021-01-20,990,99,10347,405,1.48448372333252,0.0581053356479821,1089,10752,fhi:git
county,Oslo,2021-01-21,1022,21,11369,426,1.63111002711582,0.0611182049038034,1043,11795,fhi:git
county,Oslo,2021-01-22,669,6,12038,432,1.7270914334084198,0.0619790246911809,675,12470,fhi:git
county,Oslo,2021-01-23,232,0,12270,432,1.76037646518701,0.0619790246911809,232,12702,fhi:git
county,Oslo,2021-01-24,67,0,12337,432,1.7699889528127302,0.0619790246911809,67,12769,fhi:git
county,Oslo,2021-01-25,258,0,12595,432,1.8070042036699598,0.0619790246911809,258,13027,fhi:git
county,Oslo,2021-01-26,312,404,12907,836,1.85176683261359,0.11994089037460001,716,13743,fhi:git
county,Oslo,2021-01-27,1035,528,13942,1364,2.0002582459362097,0.19569303166382102,1563,15306,fhi:git
county,Oslo,2021-01-28,869,843,14811,2207,2.12493364514139,0.316638211790362,1712,17018,fhi:git
county,Oslo,2021-01-29,426,503,15237,2710,2.1860518500451898,0.38880360396551,929,17947,fhi:git
county,Oslo,2021-01-30,94,152,15331,2862,2.1995380267141096,0.41061103857907305,246,18193,fhi:git
county,Oslo,2021-01-31,61,45,15392,2907,2.2082896945524504,0.417067186984405,106,18299,fhi:git
county,Oslo,2021-02-01,53,47,15445,2954,2.2158936026742797,0.42381027531886206,100,18399,fhi:git
county,Oslo,2021-02-02,1523,151,16968,3105,2.43439835870361,0.44547423996786295,1674,20073,fhi:git
county,Oslo,2021-02-03,2456,456,19424,3561,2.78676059167013,0.510896543808554,2912,22985,fhi:git
county,Oslo,2021-02-04,2050,1236,21474,4797,3.08087401902412,0.6882254200083211,3286,26271,fhi:git
county,Oslo,2021-02-05,1381,1568,22855,6365,3.27900604008551,0.9131863244429781,2949,29220,fhi:git
county,Oslo,2021-02-06,243,632,23098,6997,3.3138692414743,1.00385934204674,875,30095,fhi:git
county,Oslo,2021-02-07,215,270,23313,7267,3.3447152838553302,1.04259623247873,485,30580,fhi:git
county,Oslo,2021-02-08,46,443,23359,7710,3.35131490222522,1.1061534267801,489,31069,fhi:git
county,Oslo,2021-02-09,1165,244,24524,7954,3.51845741094102,1.14116009813346,1409,32478,fhi:git
county,Oslo,2021-02-10,1831,812,26355,8766,3.7811509160557204,1.25765770935855,2643,35121,fhi:git
county,Oslo,2021-02-11,1584,746,27939,9512,4.00840733992339,1.36468630292248,2330,37451,fhi:git
county,Oslo,2021-02-12,1358,424,29297,9936,4.20323955179983,1.42551756789716,1782,39233,fhi:git
county,Oslo,2021-02-13,273,193,29570,10129,4.24240685212551,1.4532072710578001,466,39699,fhi:git
county,Oslo,2021-02-14,103,0,29673,10129,4.25718425847549,1.4532072710578001,103,39802,fhi:git
county,Oslo,2021-02-15,261,444,29934,10573,4.29462991922641,1.51690793532374,705,40507,fhi:git
county,Oslo,2021-02-16,723,771,30657,11344,4.398358703605401,1.6275232780017501,1494,42001,fhi:git
county,Oslo,2021-02-17,1461,1081,32118,12425,4.60796832183182,1.78261430969427,2542,44543,fhi:git
county,Oslo,2021-02-18,1072,919,33190,13344,4.761768123843269,1.9144632071275902,1991,46534,fhi:git
county,Oslo,2021-02-19,1495,970,34685,14314,4.97625572086484,2.05362907275362,2465,48999,fhi:git
county,Oslo,2021-02-20,100,114,34785,14428,4.9906027173211305,2.06998464871379,214,49213,fhi:git
county,Oslo,2021-02-21,4,61,34789,14489,4.99117659717938,2.07873631655213,65,49278,fhi:git
county,Oslo,2021-02-22,603,112,35392,14601,5.077688985810821,2.0948049525831802,715,49993,fhi:git
county,Oslo,2021-02-23,337,1527,35729,16128,5.12603836386852,2.31388358847075,1864,51857,fhi:git
county,Oslo,2021-02-24,685,2341,36414,18469,5.22431528959412,2.6497467755125497,3026,54883,fhi:git
county,Oslo,2021-02-25,596,1953,37010,20422,5.30982338847362,2.9299436163039303,2549,57432,fhi:git
county,Oslo,2021-02-26,765,1370,37775,21792,5.41957791136426,3.12649746775513,2135,59567,fhi:git
county,Oslo,2021-02-27,258,102,38033,21894,5.45659316222149,3.14113140414054,360,59927,fhi:git
county,Oslo,2021-02-28,101,62,38134,21956,5.47108362864234,3.15002654194344,163,60090,fhi:git
county,Oslo,2021-03-01,1038,38,39172,21994,5.620005451858651,3.1554784005968397,1076,61166,fhi:git
county,Oslo,2021-03-02,767,135,39939,22129,5.73004691467841,3.1748468458128305,902,62068,fhi:git
county,Oslo,2021-03-03,1359,167,41298,22296,5.92502259651942,3.19880632989484,1526,63594,fhi:git
county,Oslo,2021-03-04,1179,203,42477,22499,6.0941736847391,3.2279307327011098,1382,64976,fhi:git
county,Oslo,2021-03-05,1289,67,43766,22566,6.2791064690607,3.23754322032682,1356,66332,fhi:git
county,Oslo,2021-03-06,97,3,43863,22569,6.293023055623309,3.2379736302205098,100,66432,fhi:git
county,Oslo,2021-03-07,68,0,43931,22569,6.30277901321358,3.2379736302205098,68,66500,fhi:git
county,Oslo,2021-03-08,650,10,44581,22579,6.39603449017948,3.23940832986614,660,67160,fhi:git
county,Oslo,2021-03-09,772,1329,45353,23908,6.506793302822059,3.43007991277026,2101,69261,fhi:git
county,Oslo,2021-03-10,1189,2392,46542,26300,6.677379090687361,3.7732600680047597,3581,72842,fhi:git
county,Oslo,2021-03-11,857,2371,47399,28671,6.8003328503177904,4.11342735398344,3228,76070,fhi:git
county,Oslo,2021-03-12,278,1636,47677,30307,6.84021750046628,4.34814421600838,1914,77984,fhi:git
county,Oslo,2021-03-13,17,265,47694,30572,6.84265648986385,4.38616375661755,282,78266,fhi:git
county,Oslo,2021-03-14,1,97,47695,30669,6.84279995982841,4.40008034318016,98,78364,fhi:git
county,Oslo,2021-03-15,24,357,47719,31026,6.8462432389779195,4.45129912052912,381,78745,fhi:git
county,Oslo,2021-03-16,1007,119,48726,31145,6.99071749329278,4.46837204631211,1126,79871,fhi:git
county,Oslo,2021-03-17,2729,91,51455,31236,7.382247026584981,4.48142781308733,2820,82691,fhi:git
county,Oslo,2021-03-18,2027,112,53482,31348,7.67306064475402,4.49749644911838,2139,84830,fhi:git
county,Oslo,2021-03-19,1989,186,55471,31534,7.95842240426967,4.52418186252708,2175,87005,fhi:git
county,Oslo,2021-03-20,391,17,55862,31551,8.01451916041377,4.52662085192465,408,87413,fhi:git
county,Oslo,2021-03-21,162,14,56024,31565,8.03776129467296,4.52862943142853,176,87589,fhi:git
county,Oslo,2021-03-22,938,10,56962,31575,8.17233612143298,4.530064131074161,948,88537,fhi:git
county,Oslo,2021-03-23,3113,91,60075,31666,8.61895812111735,4.54311989784939,3204,91741,fhi:git
county,Rogaland,2020-12-27,0,0,0,0,0.0,0.0,0,0,fhi:git
county,Rogaland,2020-12-28,1,0,1,0,0.00020838021888258202,0.0,1,1,fhi:git
county,Rogaland,2020-12-29,0,0,1,0,0.00020838021888258202,0.0,0,1,fhi:git
county,Rogaland,2020-12-30,0,0,1,0,0.00020838021888258202,0.0,0,1,fhi:git
county,Rogaland,2020-12-31,0,0,1,0,0.00020838021888258202,0.0,0,1,fhi:git
county,Rogaland,2021-01-01,0,0,1,0,0.00020838021888258202,0.0,0,1,fhi:git
county,Rogaland,2021-01-02,0,0,1,0,0.00020838021888258202,0.0,0,1,fhi:git
county,Rogaland,2021-01-03,0,0,1,0,0.00020838021888258202,0.0,0,1,fhi:git
county,Rogaland,2021-01-04,0,0,1,0,0.00020719162117084,0.0,0,1,fhi:git
county,Rogaland,2021-01-05,548,0,549,0,0.11374820002279101,0.0,548,549,fhi:git
county,Rogaland,2021-01-06,641,0,1190,0,0.24655802919329897,0.0,641,1190,fhi:git
county,Rogaland,2021-01-07,212,0,1402,0,0.290482652881517,0.0,212,1402,fhi:git
county,Rogaland,2021-01-08,20,0,1422,0,0.29462648530493396,0.0,20,1422,fhi:git
county,Rogaland,2021-01-09,1,0,1423,0,0.29483367692610496,0.0,1,1423,fhi:git
county,Rogaland,2021-01-10,0,0,1423,0,0.29483367692610496,0.0,0,1423,fhi:git
county,Rogaland,2021-01-11,2,0,1425,0,0.295248060168447,0.0,2,1425,fhi:git
county,Rogaland,2021-01-12,117,0,1542,0,0.31948947984543496,0.0,117,1542,fhi:git
county,Rogaland,2021-01-13,761,0,2303,0,0.47716230355644396,0.0,761,2303,fhi:git
county,Rogaland,2021-01-14,535,0,2838,0,0.588009820882844,0.0,535,2838,fhi:git
county,Rogaland,2021-01-15,291,0,3129,0,0.648302582643558,0.0,291,3129,fhi:git
county,Rogaland,2021-01-16,0,0,3129,0,0.648302582643558,0.0,0,3129,fhi:git
county,Rogaland,2021-01-17,2,0,3131,0,0.6487169658859,0.0,2,3131,fhi:git
county,Rogaland,2021-01-18,71,0,3202,0,0.6634275709890289,0.0,71,3202,fhi:git
county,Rogaland,2021-01-19,512,0,3714,0,0.769509681028499,0.0,512,3714,fhi:git
county,Rogaland,2021-01-20,656,0,4370,0,0.90542738451657,0.0,656,4370,fhi:git
county,Rogaland,2021-01-21,428,0,4798,0,0.9941053983776899,0.0,428,4798,fhi:git
county,Rogaland,2021-01-22,272,0,5070,0,1.05046151933616,0.0,272,5070,fhi:git
county,Rogaland,2021-01-23,0,0,5070,0,1.05046151933616,0.0,0,5070,fhi:git
county,Rogaland,2021-01-24,0,0,5070,0,1.05046151933616,0.0,0,5070,fhi:git
county,Rogaland,2021-01-25,150,0,5220,0,1.08154026251178,0.0,150,5220,fhi:git
county,Rogaland,2021-01-26,338,381,5558,381,1.15157103046753,0.07894000766609,719,5939,fhi:git
county,Rogaland,2021-01-27,865,603,6423,984,1.3307917827803,0.203876555232106,1468,7407,fhi:git
county,Rogaland,2021-01-28,524,283,6947,1267,1.43936019227382,0.262511784023454,807,8214,fhi:git
county,Rogaland,2021-01-29,410,22,7357,1289,1.52430875695387,0.267069999689213,432,8646,fhi:git
county,Rogaland,2021-01-30,4,1,7361,1290,1.52513752343855,0.267277191310383,5,8651,fhi:git
county,Rogaland,2021-01-31,0,0,7361,1290,1.52513752343855,0.267277191310383,0,8651,fhi:git
county,Rogaland,2021-02-01,13,5,7374,1295,1.5278310145137701,0.268313149416238,18,8669,fhi:git
county,Rogaland,2021-02-02,451,77,7825,1372,1.6212744356618203,0.28426690424639195,528,9197,fhi:git
county,Rogaland,2021-02-03,2431,635,10256,2007,2.12495726672813,0.41583358368987605,3066,12263,fhi:git
county,Rogaland,2021-02-04,1887,550,12143,2557,2.5159278558775098,0.529788975333838,2437,14700,fhi:git
county,Rogaland,2021-02-05,657,281,12800,2838,2.65205275098675,0.588009820882844,938,15638,fhi:git
county,Rogaland,2021-02-06,0,0,12800,2838,2.65205275098675,0.588009820882844,0,15638,fhi:git
county,Rogaland,2021-02-07,0,1,12800,2839,2.65205275098675,0.588217012504014,1,15639,fhi:git
county,Rogaland,2021-02-08,7,71,12807,2910,2.65350309233495,0.6029276176071441,78,15717,fhi:git
county,Rogaland,2021-02-09,587,394,13394,3304,2.77512457396223,0.684561116348455,981,16698,fhi:git
county,Rogaland,2021-02-10,1923,683,15317,3987,3.17355406147375,0.826072993608139,2606,19304,fhi:git
county,Rogaland,2021-02-11,1181,494,16498,4481,3.4182473660765202,0.9284256544665329,1675,20979,fhi:git
county,Rogaland,2021-02-12,482,268,16980,4749,3.5181137274808596,0.9839530089403191,750,21729,fhi:git
county,Rogaland,2021-02-13,1,0,16981,4749,3.5183209191020297,0.9839530089403191,1,21730,fhi:git
county,Rogaland,2021-02-14,0,0,16981,4749,3.5183209191020297,0.9839530089403191,0,21730,fhi:git
county,Rogaland,2021-02-15,0,147,16981,4896,3.5183209191020297,1.01441017725243,147,21877,fhi:git
county,Rogaland,2021-02-16,480,314,17461,5210,3.61777289726404,1.07946834630008,794,22671,fhi:git
county,Rogaland,2021-02-17,1488,783,18949,5993,3.9260740295662404,1.2416993856768401,2271,24942,fhi:git
county,Rogaland,2021-02-18,1101,472,20050,6465,4.154192004475339,1.33949383086948,1573,26515,fhi:git
county,Rogaland,2021-02-19,441,411,20491,6876,4.24556350941168,1.42464958717069,852,27367,fhi:git
county,Rogaland,2021-02-20,1,2,20492,6878,4.24577070103285,1.42506397041304,3,27370,fhi:git
county,Rogaland,2021-02-21,0,0,20492,6878,4.24577070103285,1.42506397041304,0,27370,fhi:git
county,Rogaland,2021-02-22,251,13,20743,6891,4.297775797946731,1.42775746148826,264,27634,fhi:git
county,Rogaland,2021-02-23,379,406,21122,7297,4.37630142237048,1.51187725968362,785,28419,fhi:git
county,Rogaland,2021-02-24,819,2168,21941,9465,4.5459913601094,1.961068694382,2987,31406,fhi:git
county,Rogaland,2021-02-25,1228,1810,23169,11275,4.80042267090719,2.3360855287012203,3038,34444,fhi:git
county,Rogaland,2021-02-26,998,675,24167,11950,5.00719990883569,2.4759398729915403,1673,36117,fhi:git
county,Rogaland,2021-02-27,1,1,24168,11951,5.00740710045686,2.47614706461271,2,36119,fhi:git
county,Rogaland,2021-02-28,4,0,24172,11951,5.00823586694154,2.47614706461271,4,36123,fhi:git
county,Rogaland,2021-03-01,647,2,24819,11953,5.14228884583907,2.4765614478550497,649,36772,fhi:git
county,Rogaland,2021-03-02,794,545,25613,12498,5.306798993048719,2.5894808813931602,1339,38111,fhi:git
county,Rogaland,2021-03-03,1242,1460,26855,13958,5.564130986542901,2.8919806483025803,2702,40813,fhi:git
county,Rogaland,2021-03-04,1067,1477,27922,15435,5.78520444633219,3.1980026727719104,2544,43357,fhi:git
county,Rogaland,2021-03-05,589,424,28511,15859,5.90724031120181,3.28585192014835,1013,44370,fhi:git
county,Rogaland,2021-03-06,2,1,28513,15860,5.907654694444161,3.28605911176952,3,44373,fhi:git
county,Rogaland,2021-03-07,0,0,28513,15860,5.907654694444161,3.28605911176952,0,44373,fhi:git
county,Rogaland,2021-03-08,539,0,29052,15860,6.0193309782552396,3.28605911176952,539,44912,fhi:git
county,Rogaland,2021-03-09,1421,464,30473,16324,6.313750271939,3.38219602399279,1885,46797,fhi:git
county,Rogaland,2021-03-10,2127,1077,32600,17401,6.75444685016938,3.6053413999937796,3204,50001,fhi:git
county,Rogaland,2021-03-11,1390,1055,33990,18456,7.042443203596849,3.82392856032902,2445,52446,fhi:git
county,Rogaland,2021-03-12,115,546,34105,19002,7.06627024003149,3.9370551854883,661,53107,fhi:git
county,Rogaland,2021-03-13,0,0,34105,19002,7.06627024003149,3.9370551854883,0,53107,fhi:git
county,Rogaland,2021-03-14,0,0,34105,19002,7.06627024003149,3.9370551854883,0,53107,fhi:git
county,Rogaland,2021-03-15,0,1,34105,19003,7.06627024003149,3.9372623771094704,1,53108,fhi:git
county,Rogaland,2021-03-16,585,93,34690,19096,7.187477338416429,3.95653119787836,678,53786,fhi:git
county,Rogaland,2021-03-17,2392,95,37082,19191,7.68307969625708,3.97621440188959,2487,56273,fhi:git
county,Rogaland,2021-03-18,1670,78,38752,19269,8.029089703612389,3.99237534834091,1748,58021,fhi:git
county,Rogaland,2021-03-19,266,24,39018,19293,8.08420267484383,3.9973479472490094,290,58311,fhi:git
county,Rogaland,2021-03-20,0,0,39018,19293,8.08420267484383,3.9973479472490094,0,58311,fhi:git
county,Rogaland,2021-03-21,0,0,39018,19293,8.08420267484383,3.9973479472490094,0,58311,fhi:git
county,Rogaland,2021-03-22,11,17,39029,19310,8.08648178267671,4.00087020480892,28,58339,fhi:git
county,Rogaland,2021-03-23,745,23,39774,19333,8.240839540448981,4.00563561209585,768,59107,fhi:git
county,Troms og Finnmark,2020-12-27,0,0,0,0,0.0,0.0,0,0,fhi:git
county,Troms og Finnmark,2020-12-28,1,0,1,0,0.00041099662571770297,0.0,1,1,fhi:git
county,Troms og Finnmark,2020-12-29,0,0,1,0,0.00041099662571770297,0.0,0,1,fhi:git
county,Troms og Finnmark,2020-12-30,0,0,1,0,0.00041099662571770297,0.0,0,1,fhi:git
county,Troms og Finnmark,2020-12-31,0,0,1,0,0.00041099662571770297,0.0,0,1,fhi:git
county,Troms og Finnmark,2021-01-01,0,0,1,0,0.00041099662571770297,0.0,0,1,fhi:git
county,Troms og Finnmark,2021-01-02,0,0,1,0,0.00041099662571770297,0.0,0,1,fhi:git
county,Troms og Finnmark,2021-01-03,0,0,1,0,0.00041099662571770297,0.0,0,1,fhi:git
county,Troms og Finnmark,2021-01-04,0,0,1,0,0.00041293647385286204,0.0,0,1,fhi:git
county,Troms og Finnmark,2021-01-05,53,0,54,0,0.0222985695880546,0.0,53,54,fhi:git
county,Troms og Finnmark,2021-01-06,530,0,584,0,0.241154900730072,0.0,530,584,fhi:git
county,Troms og Finnmark,2021-01-07,188,0,772,0,0.31878695781440997,0.0,188,772,fhi:git
county,Troms og Finnmark,2021-01-08,247,0,1019,0,0.420782266856067,0.0,247,1019,fhi:git
county,Troms og Finnmark,2021-01-09,0,0,1019,0,0.420782266856067,0.0,0,1019,fhi:git
county,Troms og Finnmark,2021-01-10,0,0,1019,0,0.420782266856067,0.0,0,1019,fhi:git
county,Troms og Finnmark,2021-01-11,1,0,1020,0,0.42119520332991994,0.0,1,1020,fhi:git
county,Troms og Finnmark,2021-01-12,191,0,1211,0,0.500066069835817,0.0,191,1211,fhi:git
county,Troms og Finnmark,2021-01-13,569,0,1780,0,0.7350269234580951,0.0,569,1780,fhi:git
county,Troms og Finnmark,2021-01-14,330,0,2110,0,0.8712959598295401,0.0,330,2110,fhi:git
county,Troms og Finnmark,2021-01-15,37,0,2147,0,0.8865746093620959,0.0,37,2147,fhi:git
county,Troms og Finnmark,2021-01-16,2,0,2149,0,0.8874004823098021,0.0,2,2149,fhi:git
county,Troms og Finnmark,2021-01-17,0,0,2149,0,0.8874004823098021,0.0,0,2149,fhi:git
county,Troms og Finnmark,2021-01-18,0,1,2149,1,0.8874004823098021,0.00041293647385286204,1,2150,fhi:git
county,Troms og Finnmark,2021-01-19,252,0,2401,1,0.9914604737207231,0.00041293647385286204,252,2402,fhi:git
county,Troms og Finnmark,2021-01-20,924,0,3325,1,1.37301377556077,0.00041293647385286204,924,3326,fhi:git
county,Troms og Finnmark,2021-01-21,247,0,3572,1,1.47500908460242,0.00041293647385286204,247,3573,fhi:git
county,Troms og Finnmark,2021-01-22,81,0,3653,1,1.50845693898451,0.00041293647385286204,81,3654,fhi:git
county,Troms og Finnmark,2021-01-23,12,0,3665,1,1.51341217667074,0.00041293647385286204,12,3666,fhi:git
county,Troms og Finnmark,2021-01-24,0,0,3665,1,1.51341217667074,0.00041293647385286204,0,3666,fhi:git
county,Troms og Finnmark,2021-01-25,6,0,3671,1,1.51588979551386,0.00041293647385286204,6,3672,fhi:git
county,Troms og Finnmark,2021-01-26,85,0,3756,1,1.55098939579135,0.00041293647385286204,85,3757,fhi:git
county,Troms og Finnmark,2021-01-27,667,357,4423,358,1.8264180238512098,0.14783125763932503,1024,4781,fhi:git
county,Troms og Finnmark,2021-01-28,235,276,4658,634,1.92345809520663,0.261801724422715,511,5292,fhi:git
county,Troms og Finnmark,2021-01-29,104,243,4762,877,1.96640348848733,0.36214528756896003,347,5639,fhi:git
county,Troms og Finnmark,2021-01-30,0,0,4762,877,1.96640348848733,0.36214528756896003,0,5639,fhi:git
county,Troms og Finnmark,2021-01-31,0,0,4762,877,1.96640348848733,0.36214528756896003,0,5639,fhi:git
county,Troms og Finnmark,2021-02-01,0,2,4762,879,1.96640348848733,0.362971160516666,2,5641,fhi:git
county,Troms og Finnmark,2021-02-02,119,24,4881,903,2.01554292887582,0.372881635889135,143,5784,fhi:git
county,Troms og Finnmark,2021-02-03,1159,562,6040,1465,2.49413630207129,0.6049519341944439,1721,7505,fhi:git
county,Troms og Finnmark,2021-02-04,1149,380,7189,1845,2.96860031052823,0.7618677942585309,1529,9034,fhi:git
county,Troms og Finnmark,2021-02-05,287,140,7476,1985,3.087113078524,0.819678900597932,427,9461,fhi:git
county,Troms og Finnmark,2021-02-06,1,1,7477,1986,3.08752601499785,0.820091837071785,2,9463,fhi:git
county,Troms og Finnmark,2021-02-07,0,0,7477,1986,3.08752601499785,0.820091837071785,0,9463,fhi:git
county,Troms og Finnmark,2021-02-08,0,0,7477,1986,3.08752601499785,0.820091837071785,0,9463,fhi:git
county,Troms og Finnmark,2021-02-09,71,30,7548,2016,3.11684450464141,0.832479931287371,101,9564,fhi:git
county,Troms og Finnmark,2021-02-10,1408,813,8956,2829,3.69825905982624,1.1681972845297501,2221,11785,fhi:git
county,Troms og Finnmark,2021-02-11,996,465,9952,3294,4.10954378778369,1.36021274487133,1461,13246,fhi:git
county,Troms og Finnmark,2021-02-12,294,113,10246,3407,4.23094711109643,1.4068745664167,407,13653,fhi:git
county,Troms og Finnmark,2021-02-13,5,2,10251,3409,4.23301179346569,1.4077004393644101,7,13660,fhi:git
county,Troms og Finnmark,2021-02-14,0,0,10251,3409,4.23301179346569,1.4077004393644101,0,13660,fhi:git
county,Troms og Finnmark,2021-02-15,0,6,10251,3415,4.23301179346569,1.41017805820753,6,13666,fhi:git
county,Troms og Finnmark,2021-02-16,133,52,10384,3467,4.28793234448812,1.43165075484787,185,13851,fhi:git
county,Troms og Finnmark,2021-02-17,967,581,11351,4048,4.68724191470384,1.67156684615639,1548,15399,fhi:git
county,Troms og Finnmark,2021-02-18,1295,263,12646,4311,5.2219946483432995,1.78016913877969,1558,16957,fhi:git
county,Troms og Finnmark,2021-02-19,233,133,12879,4444,5.31820884675102,1.83508968980212,366,17323,fhi:git
county,Troms og Finnmark,2021-02-20,0,0,12879,4444,5.31820884675102,1.83508968980212,0,17323,fhi:git
county,Troms og Finnmark,2021-02-21,0,0,12879,4444,5.31820884675102,1.83508968980212,0,17323,fhi:git
county,Troms og Finnmark,2021-02-22,107,0,12986,4444,5.362393049453269,1.83508968980212,107,17430,fhi:git
county,Troms og Finnmark,2021-02-23,79,78,13065,4522,5.3950150308876506,1.86729873476264,157,17587,fhi:git
county,Troms og Finnmark,2021-02-24,429,989,13494,5511,5.572164778170531,2.27569290740313,1418,19005,fhi:git
county,Troms og Finnmark,2021-02-25,567,1054,14061,6565,5.806299758845099,2.71092795084404,1621,20626,fhi:git
county,Troms og Finnmark,2021-02-26,283,403,14344,6968,5.92316078094546,2.8773413498067497,686,21312,fhi:git
county,Troms og Finnmark,2021-02-27,0,0,14344,6968,5.92316078094546,2.8773413498067497,0,21312,fhi:git
county,Troms og Finnmark,2021-02-28,3,0,14347,6968,5.9243995903670195,2.8773413498067497,3,21315,fhi:git
county,Troms og Finnmark,2021-03-01,340,0,14687,6968,6.06479799147699,2.8773413498067497,340,21655,fhi:git
county,Troms og Finnmark,2021-03-02,555,72,15242,7040,6.293977734465329,2.9070727759241497,627,22282,fhi:git
county,Troms og Finnmark,2021-03-03,599,1179,15841,8219,6.5413266823031995,3.39392487859668,1778,24060,fhi:git
county,Troms og Finnmark,2021-03-04,869,934,16710,9153,6.90016847808133,3.77960754517525,1803,25863,fhi:git
county,Troms og Finnmark,2021-03-05,700,373,17410,9526,7.18922400977834,3.9336328499223705,1073,26936,fhi:git
county,Troms og Finnmark,2021-03-06,0,1,17410,9527,7.18922400977834,3.9340457863962204,1,26937,fhi:git
county,Troms og Finnmark,2021-03-07,0,0,17410,9527,7.18922400977834,3.9340457863962204,0,26937,fhi:git
county,Troms og Finnmark,2021-03-08,408,0,17818,9527,7.3577020911102995,3.9340457863962204,408,27345,fhi:git
county,Troms og Finnmark,2021-03-09,603,51,18421,9578,7.60670278484358,3.95510554656272,654,27999,fhi:git
county,Troms og Finnmark,2021-03-10,938,698,19359,10276,7.994037197317571,4.24333520531201,1636,29635,fhi:git
county,Troms og Finnmark,2021-03-11,793,1039,20152,11315,8.321495821082879,4.67237620164514,1832,31467,fhi:git
county,Troms og Finnmark,2021-03-12,68,209,20220,11524,8.34957550130488,4.75867992468039,277,31744,fhi:git
county,Troms og Finnmark,2021-03-13,0,0,20220,11524,8.34957550130488,4.75867992468039,0,31744,fhi:git
county,Troms og Finnmark,2021-03-14,0,0,20220,11524,8.34957550130488,4.75867992468039,0,31744,fhi:git
county,Troms og Finnmark,2021-03-15,2,5,20222,11529,8.35040137425258,4.76074460704965,7,31751,fhi:git
county,Troms og Finnmark,2021-03-16,18,2,20240,11531,8.35783423078194,4.76157047999736,20,31771,fhi:git
county,Troms og Finnmark,2021-03-17,541,45,20781,11576,8.581232863136341,4.78015262132074,586,32357,fhi:git
county,Troms og Finnmark,2021-03-18,1109,122,21890,11698,9.039179412639161,4.83053087113079,1231,33588,fhi:git
county,Troms og Finnmark,2021-03-19,405,33,22295,11731,9.20641868454957,4.84415777476793,438,34026,fhi:git
county,Troms og Finnmark,2021-03-20,0,0,22295,11731,9.20641868454957,4.84415777476793,0,34026,fhi:git
county,Troms og Finnmark,2021-03-21,1,0,22296,11731,9.20683162102342,4.84415777476793,1,34027,fhi:git
county,Troms og Finnmark,2021-03-22,3,0,22299,11731,9.20807043044498,4.84415777476793,3,34030,fhi:git
county,Troms og Finnmark,2021-03-23,411,7,22710,11738,9.37778732119851,4.8470483300849,418,34448,fhi:git
county,Trøndelag,2020-12-27,0,0,0,0,0.0,0.0,0,0,fhi:git
county,Trøndelag,2020-12-28,0,0,0,0,0.0,0.0,0,0,fhi:git
county,Trøndelag,2020-12-29,0,0,0,0,0.0,0.0,0,0,fhi:git
county,Trøndelag,2020-12-30,0,0,0,0,0.0,0.0,0,0,fhi:git
county,Trøndelag,2020-12-31,0,0,0,0,0.0,0.0,0,0,fhi:git
county,Trøndelag,2021-01-01,0,0,0,0,0.0,0.0,0,0,fhi:git
county,Trøndelag,2021-01-02,0,0,0,0,0.0,0.0,0,0,fhi:git
county,Trøndelag,2021-01-03,0,0,0,0,0.0,0.0,0,0,fhi:git
county,Trøndelag,2021-01-04,3,0,3,0,0.000636775031626493,0.0,3,3,fhi:git
county,Trøndelag,2021-01-05,407,0,410,0,0.0870259209889541,0.0,407,410,fhi:git
county,Trøndelag,2021-01-06,674,0,1084,0,0.23008804476104003,0.0,674,1084,fhi:git
county,Trøndelag,2021-01-07,484,0,1568,0,0.332821083196781,0.0,484,1568,fhi:git
county,Trøndelag,2021-01-08,141,0,1709,0,0.36274950968322606,0.0,141,1709,fhi:git
county,Trøndelag,2021-01-09,0,0,1709,0,0.36274950968322606,0.0,0,1709,fhi:git
county,Trøndelag,2021-01-10,0,0,1709,0,0.36274950968322606,0.0,0,1709,fhi:git
county,Trøndelag,2021-01-11,95,0,1804,0,0.38291405235139797,0.0,95,1804,fhi:git
county,Trøndelag,2021-01-12,499,0,2303,0,0.48883096594527103,0.0,499,2303,fhi:git
county,Trøndelag,2021-01-13,860,0,3163,0,0.6713731416781991,0.0,860,3163,fhi:git
county,Trøndelag,2021-01-14,670,0,3833,0,0.813586232074783,0.0,670,3833,fhi:git
county,Trøndelag,2021-01-15,253,0,4086,0,0.867287593075284,0.0,253,4086,fhi:git
county,Trøndelag,2021-01-16,0,0,4086,0,0.867287593075284,0.0,0,4086,fhi:git
county,Trøndelag,2021-01-17,0,0,4086,0,0.867287593075284,0.0,0,4086,fhi:git
county,Trøndelag,2021-01-18,152,0,4238,0,0.899550861344359,0.0,152,4238,fhi:git
county,Trøndelag,2021-01-19,567,0,4805,0,1.01990134232177,0.0,567,4805,fhi:git
county,Trøndelag,2021-01-20,739,0,5544,0,1.17676025844576,0.0,739,5544,fhi:git
county,Trøndelag,2021-01-21,530,0,6074,0,1.28925718069977,0.0,530,6074,fhi:git
county,Trøndelag,2021-01-22,283,0,6357,0,1.34932629201654,0.0,283,6357,fhi:git
county,Trøndelag,2021-01-23,1,0,6358,0,1.3495385503604098,0.0,1,6358,fhi:git
county,Trøndelag,2021-01-24,0,0,6358,0,1.3495385503604098,0.0,0,6358,fhi:git
county,Trøndelag,2021-01-25,1,0,6359,0,1.34975080870429,0.0,1,6359,fhi:git
county,Trøndelag,2021-01-26,313,184,6672,184,1.41618767033732,0.0390555352730916,497,6856,fhi:git
county,Trøndelag,2021-01-27,1006,604,7678,788,1.62971956427607,0.167259574973892,1610,8466,fhi:git
county,Trøndelag,2021-01-28,727,483,8405,1271,1.78403138027356,0.269780355065758,1210,9676,fhi:git
county,Trøndelag,2021-01-29,420,229,8825,1500,1.8731798847012702,0.318387515813247,649,10325,fhi:git
county,Trøndelag,2021-01-30,1,0,8826,1500,1.87339214304514,0.318387515813247,1,10326,fhi:git
county,Trøndelag,2021-01-31,2,1,8828,1501,1.8738166597328898,0.318599774157122,3,10329,fhi:git
county,Trøndelag,2021-02-01,14,86,8842,1587,1.87678827654715,0.336853991730415,100,10429,fhi:git
county,Trøndelag,2021-02-02,836,392,9678,1979,2.05423625202707,0.42005926252960996,1228,11657,fhi:git
county,Trøndelag,2021-02-03,2126,809,11804,2788,2.50549749110638,0.5917762627248879,2935,14592,fhi:git
county,Trøndelag,2021-02-04,2143,607,13947,3395,2.96036712203157,0.7206170774573148,2750,17342,fhi:git
county,Trøndelag,2021-02-05,1293,319,15240,3714,3.2348171606625895,0.7883274891535992,1612,18954,fhi:git
county,Trøndelag,2021-02-06,7,0,15247,3714,3.2363029690697096,0.7883274891535992,7,18961,fhi:git
county,Trøndelag,2021-02-07,1,0,15248,3714,3.23651522741359,0.7883274891535992,1,18962,fhi:git
county,Trøndelag,2021-02-08,3,150,15251,3864,3.2371520024452205,0.8201662407349231,153,19115,fhi:git
county,Trøndelag,2021-02-09,836,522,16087,4386,3.41459997792513,0.930965096237933,1358,20473,fhi:git
county,Trøndelag,2021-02-10,2230,629,18317,5015,3.88793608476749,1.0644755945356201,2859,23332,fhi:git
county,Trøndelag,2021-02-11,2363,582,20680,5597,4.38950255134529,1.1880099506711599,2945,26277,fhi:git
county,Trøndelag,2021-02-12,887,352,21567,5949,4.57777570236286,1.26272488771534,1239,27516,fhi:git
county,Trøndelag,2021-02-13,2,0,21569,5949,4.57820021905061,1.26272488771534,2,27518,fhi:git
county,Trøndelag,2021-02-14,0,0,21569,5949,4.57820021905061,1.26272488771534,0,27518,fhi:git
county,Trøndelag,2021-02-15,0,2,21569,5951,4.57820021905061,1.26314940440309,2,27520,fhi:git
county,Trøndelag,2021-02-16,344,210,21913,6161,4.65121708934378,1.30772365661694,554,28074,fhi:git
county,Trøndelag,2021-02-17,2223,916,24136,7077,5.12306738777901,1.5021522996068999,3139,31213,fhi:git
county,Trøndelag,2021-02-18,2100,752,26236,7829,5.56880990991756,1.66177057420127,2852,34065,fhi:git
county,Trøndelag,2021-02-19,1261,411,27497,8240,5.836467681544559,1.7490087535341001,1672,35737,fhi:git
county,Trøndelag,2021-02-20,1,1,27498,8241,5.83667993988844,1.7492210118779798,2,35739,fhi:git
county,Trøndelag,2021-02-21,0,4,27498,8245,5.83667993988844,1.75007004525348,4,35743,fhi:git
county,Trøndelag,2021-02-22,17,2,27515,8247,5.84028833173432,1.75049456194123,19,35762,fhi:git
county,Trøndelag,2021-02-23,334,674,27849,8921,5.91118261858874,1.8935566857133201,1008,36770,fhi:git
county,Trøndelag,2021-02-24,1011,2048,28860,10969,6.12577580424687,2.3282617739703397,3059,39829,fhi:git
county,Trøndelag,2021-02-25,473,1981,29333,12950,6.22617400089998,2.7487455531877,2454,42283,fhi:git
county,Trøndelag,2021-02-26,611,1151,29944,14101,6.3558638490079105,2.99305490698839,1762,44045,fhi:git
county,Trøndelag,2021-02-27,4,1,29948,14102,6.35671288238341,2.9932671653322704,5,44050,fhi:git
county,Trøndelag,2021-02-28,1,0,29949,14102,6.35692514072728,2.9932671653322704,1,44051,fhi:git
county,Trøndelag,2021-03-01,528,0,30477,14102,6.46899754629355,2.9932671653322704,528,44579,fhi:git
county,Trøndelag,2021-03-02,818,785,31295,14887,6.6426248715837,3.15988996527454,1603,46182,fhi:git
county,Trøndelag,2021-03-03,2000,2094,33295,16981,7.0671415593347,3.60435893734983,4094,50276,fhi:git
county,Trøndelag,2021-03-04,1870,2280,35165,19261,7.4640646623818805,4.08830796138596,4150,54426,fhi:git
county,Trøndelag,2021-03-05,1048,981,36213,20242,7.6865114067634,4.29653339672783,2029,56455,fhi:git
county,Trøndelag,2021-03-06,0,0,36213,20242,7.6865114067634,4.29653339672783,0,56455,fhi:git
county,Trøndelag,2021-03-07,0,1,36213,20243,7.6865114067634,4.2967456550717005,1,56456,fhi:git
county,Trøndelag,2021-03-08,435,0,36648,20243,7.77884378634924,4.2967456550717005,435,56891,fhi:git
county,Trøndelag,2021-03-09,1170,301,37818,20544,8.027186048683571,4.36063541657823,1471,58362,fhi:git
county,Trøndelag,2021-03-10,1685,1490,39503,22034,8.384841358113789,4.67690034895272,3175,61537,fhi:git
county,Trøndelag,2021-03-11,844,1175,40347,23209,8.563987400344711,4.9263039030064295,2019,63556,fhi:git
county,Trøndelag,2021-03-12,123,499,40470,23708,8.59009517664139,5.0322208166003,622,64178,fhi:git
county,Trøndelag,2021-03-13,0,1,40470,23709,8.59009517664139,5.03243307494418,1,64179,fhi:git
county,Trøndelag,2021-03-14,0,0,40470,23709,8.59009517664139,5.03243307494418,0,64179,fhi:git
county,Trøndelag,2021-03-15,3,6,40473,23715,8.59073195167302,5.033706625007429,9,64188,fhi:git
county,Trøndelag,2021-03-16,606,12,41079,23727,8.71936050806157,5.036253725133941,618,64806,fhi:git
county,Trøndelag,2021-03-17,1975,120,43054,23847,9.13857073721568,5.06172472639899,2095,66901,fhi:git
county,Trøndelag,2021-03-18,1491,122,44545,23969,9.45504792793405,5.087620244351809,1613,68514,fhi:git
county,Trøndelag,2021-03-19,542,84,45087,24053,9.57009195031457,5.10544994523735,626,69140,fhi:git
county,Trøndelag,2021-03-20,0,0,45087,24053,9.57009195031457,5.10544994523735,0,69140,fhi:git
county,Trøndelag,2021-03-21,0,0,45087,24053,9.57009195031457,5.10544994523735,0,69140,fhi:git
county,Trøndelag,2021-03-22,1,0,45088,24053,9.570304208658438,5.10544994523735,1,69141,fhi:git
county,Trøndelag,2021-03-23,610,45,45698,24098,9.6997817984225,5.11500157071175,655,69796,fhi:git
county,Vestfold og Telemark,2020-12-27,0,0,0,0,0.0,0.0,0,0,fhi:git
county,Vestfold og Telemark,2020-12-28,0,0,0,0,0.0,0.0,0,0,fhi:git
county,Vestfold og Telemark,2020-12-29,0,0,0,0,0.0,0.0,0,0,fhi:git
county,Vestfold og Telemark,2020-12-30,0,0,0,0,0.0,0.0,0,0,fhi:git
county,Vestfold og Telemark,2020-12-31,0,0,0,0,0.0,0.0,0,0,fhi:git
county,Vestfold og Telemark,2021-01-01,0,0,0,0,0.0,0.0,0,0,fhi:git
county,Vestfold og Telemark,2021-01-02,0,0,0,0,0.0,0.0,0,0,fhi:git
county,Vestfold og Telemark,2021-01-03,0,0,0,0,0.0,0.0,0,0,fhi:git
county,Vestfold og Telemark,2021-01-04,1,0,1,0,0.000237033104043311,0.0,1,1,fhi:git
county,Vestfold og Telemark,2021-01-05,218,0,219,0,0.051910249785484995,0.0,218,219,fhi:git
county,Vestfold og Telemark,2021-01-06,1026,0,1245,0,0.295106214533922,0.0,1026,1245,fhi:git
county,Vestfold og Telemark,2021-01-07,442,0,1687,0,0.39987484652106503,0.0,442,1687,fhi:git
county,Vestfold og Telemark,2021-01-08,63,0,1750,0,0.41480793207579403,0.0,63,1750,fhi:git
county,Vestfold og Telemark,2021-01-09,0,0,1750,0,0.41480793207579403,0.0,0,1750,fhi:git
county,Vestfold og Telemark,2021-01-10,3,0,1753,0,0.415519031387924,0.0,3,1753,fhi:git
county,Vestfold og Telemark,2021-01-11,3,0,1756,0,0.41623013070005394,0.0,3,1756,fhi:git
county,Vestfold og Telemark,2021-01-12,420,0,2176,0,0.5157840343982439,0.0,420,2176,fhi:git
county,Vestfold og Telemark,2021-01-13,1165,0,3341,0,0.7919276006087009,0.0,1165,3341,fhi:git
county,Vestfold og Telemark,2021-01-14,583,0,3924,0,0.9301179002659509,0.0,583,3924,fhi:git
county,Vestfold og Telemark,2021-01-15,157,0,4081,0,0.9673320976007509,0.0,157,4081,fhi:git
county,Vestfold og Telemark,2021-01-16,3,0,4084,0,0.968043196912881,0.0,3,4084,fhi:git
county,Vestfold og Telemark,2021-01-17,42,0,4126,0,0.9779985872827,0.0,42,4126,fhi:git
county,Vestfold og Telemark,2021-01-18,7,0,4133,0,0.9796578190110029,0.0,7,4133,fhi:git
county,Vestfold og Telemark,2021-01-19,232,0,4365,0,1.03464949914905,0.0,232,4365,fhi:git
county,Vestfold og Telemark,2021-01-20,1607,0,5972,0,1.4155616973466498,0.0,1607,5972,fhi:git
county,Vestfold og Telemark,2021-01-21,829,0,6801,0,1.61206214059856,0.0,829,6801,fhi:git
county,Vestfold og Telemark,2021-01-22,181,0,6982,0,1.6549651324304,0.0,181,6982,fhi:git
county,Vestfold og Telemark,2021-01-23,3,0,6985,0,1.6556762317425302,0.0,3,6985,fhi:git
county,Vestfold og Telemark,2021-01-24,0,0,6985,0,1.6556762317425302,0.0,0,6985,fhi:git
county,Vestfold og Telemark,2021-01-25,44,0,7029,0,1.66610568832043,0.0,44,7029,fhi:git
county,Vestfold og Telemark,2021-01-26,103,179,7132,179,1.69052009803689,0.0424289256237526,282,7311,fhi:git
county,Vestfold og Telemark,2021-01-27,1625,898,8757,1077,2.07569889210727,0.25528465305464604,2523,9834,fhi:git
county,Vestfold og Telemark,2021-01-28,653,449,9410,1526,2.2304815090475496,0.36171251677009203,1102,10936,fhi:git
county,Vestfold og Telemark,2021-01-29,86,90,9496,1616,2.2508663559952797,0.38304549613398997,176,11112,fhi:git
county,Vestfold og Telemark,2021-01-30,0,0,9496,1616,2.2508663559952797,0.38304549613398997,0,11112,fhi:git
county,Vestfold og Telemark,2021-01-31,1,2,9497,1618,2.25110338909932,0.38351956234207707,3,11115,fhi:git
county,Vestfold og Telemark,2021-02-01,50,1,9547,1619,2.2629550443014903,0.38375659544611995,51,11166,fhi:git
county,Vestfold og Telemark,2021-02-02,464,327,10011,1946,2.37293840457758,0.4612664204682829,791,11957,fhi:git
county,Vestfold og Telemark,2021-02-03,3215,847,13226,2793,3.1349998340768304,0.662033459592967,4062,16019,fhi:git
county,Vestfold og Telemark,2021-02-04,1903,708,15129,3501,3.58607383107125,0.8298528972556309,2611,18630,fhi:git
county,Vestfold og Telemark,2021-02-05,964,245,16093,3746,3.814573743369,0.8879260077462421,1209,19839,fhi:git
county,Vestfold og Telemark,2021-02-06,0,4,16093,3750,3.814573743369,0.8888741401624151,4,19843,fhi:git
county,Vestfold og Telemark,2021-02-07,2,1,16095,3751,3.8150478095770897,0.889111173266458,3,19846,fhi:git
county,Vestfold og Telemark,2021-02-08,17,46,16112,3797,3.81907737234582,0.900014696052451,63,19909,fhi:git
county,Vestfold og Telemark,2021-02-09,356,208,16468,4005,3.90346115738524,0.9493175816934591,564,20473,fhi:git
county,Vestfold og Telemark,2021-02-10,2889,1396,19357,5401,4.58824979496637,1.28021579493792,4285,24758,fhi:git
county,Vestfold og Telemark,2021-02-11,1540,878,20897,6279,4.953280775193059,1.4883308602879501,2418,27176,fhi:git
county,Vestfold og Telemark,2021-02-12,602,213,21499,6492,5.09597470382714,1.5388189114491697,815,27991,fhi:git
county,Vestfold og Telemark,2021-02-13,2,2,21501,6494,5.09644877003522,1.53929297765726,4,27995,fhi:git
county,Vestfold og Telemark,2021-02-14,0,0,21501,6494,5.09644877003522,1.53929297765726,0,27995,fhi:git
county,Vestfold og Telemark,2021-02-15,4,2,21505,6496,5.0973969024514005,1.5397670438653501,6,28001,fhi:git
county,Vestfold og Telemark,2021-02-16,582,76,22087,6572,5.235350169004599,1.5577815597726399,658,28659,fhi:git
county,Vestfold og Telemark,2021-02-17,3042,1532,25129,8104,5.95640487150435,1.92091627516699,4574,33233,fhi:git
county,Vestfold og Telemark,2021-02-18,1818,627,26947,8731,6.387331054655089,2.0695360314021496,2445,35678,fhi:git
county,Vestfold og Telemark,2021-02-19,284,83,27231,8814,6.4546484562033895,2.08920977903774,367,36045,fhi:git
county,Vestfold og Telemark,2021-02-20,0,1,27231,8815,6.4546484562033895,2.0894468121417797,1,36046,fhi:git
county,Vestfold og Telemark,2021-02-21,1,1,27232,8816,6.454885489307441,2.08968384524583,2,36048,fhi:git
county,Vestfold og Telemark,2021-02-22,50,0,27282,8816,6.466737144509599,2.08968384524583,50,36098,fhi:git
county,Vestfold og Telemark,2021-02-23,626,385,27908,9201,6.615119867640719,2.1809415903025,1011,37109,fhi:git
county,Vestfold og Telemark,2021-02-24,665,2869,28573,12070,6.772746881829519,2.8609895658027593,3534,40643,fhi:git
county,Vestfold og Telemark,2021-02-25,701,1991,29274,14061,6.938907087763879,3.33292247595299,2692,43335,fhi:git
county,Vestfold og Telemark,2021-02-26,542,845,29816,14906,7.06737903015535,3.5332154488695897,1387,44722,fhi:git
county,Vestfold og Telemark,2021-02-27,3,2,29819,14908,7.06809012946748,3.5336895150776804,5,44727,fhi:git
county,Vestfold og Telemark,2021-02-28,0,0,29819,14908,7.06809012946748,3.5336895150776804,0,44727,fhi:git
county,Vestfold og Telemark,2021-03-01,604,0,30423,14908,7.21125812430964,3.5336895150776804,604,45331,fhi:git
county,Vestfold og Telemark,2021-03-02,843,354,31266,15262,7.4110770310181495,3.6175992339090097,1197,46528,fhi:git
county,Vestfold og Telemark,2021-03-03,1973,2813,33239,18075,7.878743345295599,4.28437335558284,4786,51314,fhi:git
county,Vestfold og Telemark,2021-03-04,1012,1430,34251,19505,8.11862084658744,4.62333069436478,2442,53756,fhi:git
county,Vestfold og Telemark,2021-03-05,1479,584,35730,20089,8.46919280746749,4.761758027126071,2063,55819,fhi:git
county,Vestfold og Telemark,2021-03-06,2,1,35732,20090,8.46966687367558,4.76199506023011,3,55822,fhi:git
county,Vestfold og Telemark,2021-03-07,0,0,35732,20090,8.46966687367558,4.76199506023011,0,55822,fhi:git
county,Vestfold og Telemark,2021-03-08,236,0,35968,20090,8.5256066862298,4.76199506023011,236,56058,fhi:git
county,Vestfold og Telemark,2021-03-09,934,142,36902,20232,8.74699560540625,4.795653761004259,1076,57134,fhi:git
county,Vestfold og Telemark,2021-03-10,1580,2263,38482,22495,9.12150790979468,5.3320596754542695,3843,60977,fhi:git
county,Vestfold og Telemark,2021-03-11,293,819,38775,23314,9.190958609279368,5.52618978766575,1112,62089,fhi:git
county,Vestfold og Telemark,2021-03-12,34,126,38809,23440,9.199017734816849,5.556055958775199,160,62249,fhi:git
county,Vestfold og Telemark,2021-03-13,1,1,38810,23441,9.199254767920891,5.55629299187925,2,62251,fhi:git
county,Vestfold og Telemark,2021-03-14,0,0,38810,23441,9.199254767920891,5.55629299187925,0,62251,fhi:git
county,Vestfold og Telemark,2021-03-15,2,3,38812,23444,9.19972883412897,5.55700409119138,5,62256,fhi:git
county,Vestfold og Telemark,2021-03-16,402,25,39214,23469,9.295016141954381,5.56292991879246,427,62683,fhi:git
county,Vestfold og Telemark,2021-03-17,3102,166,42316,23635,10.0302928306967,5.60227741406365,3268,65951,fhi:git
county,Vestfold og Telemark,2021-03-18,906,50,43222,23685,10.24504482296,5.614129069265809,956,66907,fhi:git
county,Vestfold og Telemark,2021-03-19,27,32,43249,23717,10.251444716769099,5.621714128595201,59,66966,fhi:git
county,Vestfold og Telemark,2021-03-20,0,0,43249,23717,10.251444716769099,5.621714128595201,0,66966,fhi:git
county,Vestfold og Telemark,2021-03-21,0,0,43249,23717,10.251444716769099,5.621714128595201,0,66966,fhi:git
county,Vestfold og Telemark,2021-03-22,0,0,43249,23717,10.251444716769099,5.621714128595201,0,66966,fhi:git
county,Vestfold og Telemark,2021-03-23,654,34,43903,23751,10.4064643668135,5.629773254132671,688,67654,fhi:git
county,Vestland,2020-12-27,0,0,0,0,0.0,0.0,0,0,fhi:git
county,Vestland,2020-12-28,0,0,0,0,0.0,0.0,0,0,fhi:git
county,Vestland,2020-12-29,0,0,0,0,0.0,0.0,0,0,fhi:git
county,Vestland,2020-12-30,0,0,0,0,0.0,0.0,0,0,fhi:git
county,Vestland,2020-12-31,0,0,0,0,0.0,0.0,0,0,fhi:git
county,Vestland,2021-01-01,0,0,0,0,0.0,0.0,0,0,fhi:git
county,Vestland,2021-01-02,0,0,0,0,0.0,0.0,0,0,fhi:git
county,Vestland,2021-01-03,0,0,0,0,0.0,0.0,0,0,fhi:git
county,Vestland,2021-01-04,2,0,2,0,0.000313076746068147,0.0,2,2,fhi:git
county,Vestland,2021-01-05,416,0,418,0,0.0654330399282428,0.0,416,418,fhi:git
county,Vestland,2021-01-06,1256,0,1674,0,0.262045236459039,0.0,1256,1674,fhi:git
county,Vestland,2021-01-07,715,0,2389,0,0.37397017317840203,0.0,715,2389,fhi:git
county,Vestland,2021-01-08,139,0,2528,0,0.3957290070301379,0.0,139,2528,fhi:git
county,Vestland,2021-01-09,0,0,2528,0,0.3957290070301379,0.0,0,2528,fhi:git
county,Vestland,2021-01-10,0,0,2528,0,0.3957290070301379,0.0,0,2528,fhi:git
county,Vestland,2021-01-11,65,0,2593,0,0.40590400127735293,0.0,65,2593,fhi:git
county,Vestland,2021-01-12,855,0,3448,0,0.5397443102214861,0.0,855,3448,fhi:git
county,Vestland,2021-01-13,1126,0,4574,0,0.7160065182578531,0.0,1126,4574,fhi:git
county,Vestland,2021-01-14,999,0,5573,0,0.8723883529188929,0.0,999,5573,fhi:git
county,Vestland,2021-01-15,425,0,5998,0,0.938917161458374,0.0,425,5998,fhi:git
county,Vestland,2021-01-16,2,0,6000,0,0.939230238204442,0.0,2,6000,fhi:git
county,Vestland,2021-01-17,1,0,6001,0,0.9393867765774759,0.0,1,6001,fhi:git
county,Vestland,2021-01-18,62,0,6063,0,0.949092155705589,0.0,62,6063,fhi:git
county,Vestland,2021-01-19,367,0,6430,0,1.00654173860909,0.0,367,6430,fhi:git
county,Vestland,2021-01-20,1235,0,7665,0,1.19986662930618,0.0,1235,7665,fhi:git
county,Vestland,2021-01-21,781,0,8446,0,1.3221230986457901,0.0,781,8446,fhi:git
county,Vestland,2021-01-22,312,0,8758,0,1.3709630710324199,0.0,312,8758,fhi:git
county,Vestland,2021-01-23,0,0,8758,0,1.3709630710324199,0.0,0,8758,fhi:git
county,Vestland,2021-01-24,0,0,8758,0,1.3709630710324199,0.0,0,8758,fhi:git
county,Vestland,2021-01-25,2,0,8760,0,1.3712761477784898,0.0,2,8760,fhi:git
county,Vestland,2021-01-26,152,174,8912,174,1.3950699804796698,0.0272376769079288,326,9086,fhi:git
county,Vestland,2021-01-27,1590,1210,10502,1384,1.6439659936038402,0.21664910827915804,2800,11886,fhi:git
county,Vestland,2021-01-28,1959,695,12461,2079,1.95062466637759,0.325443277537839,2654,14540,fhi:git
county,Vestland,2021-01-29,481,176,12942,2255,2.02591962380698,0.352994031191836,657,15197,fhi:git
county,Vestland,2021-01-30,3,0,12945,2255,2.0263892389260802,0.352994031191836,3,15200,fhi:git
county,Vestland,2021-01-31,1,0,12946,2255,2.02654577729912,0.352994031191836,1,15201,fhi:git
county,Vestland,2021-02-01,13,59,12959,2314,2.02858077614856,0.362229795200847,72,15273,fhi:git
county,Vestland,2021-02-02,722,581,13681,2895,2.1416014814791597,0.45317858993364296,1303,16576,fhi:git
county,Vestland,2021-02-03,2830,1043,16511,3938,2.5846050771655897,0.6164481130081819,3873,20449,fhi:git
county,Vestland,2021-02-04,2589,1103,19100,5041,2.98988292495081,0.789109938464766,3692,24141,fhi:git
county,Vestland,2021-02-05,911,487,20011,5528,3.13248938278485,0.86534412613236,1398,25539,fhi:git
county,Vestland,2021-02-06,0,2,20011,5530,3.13248938278485,0.865657202878428,2,25541,fhi:git
county,Vestland,2021-02-07,2,1,20013,5531,3.13280245953092,0.8658137412514622,3,25544,fhi:git
county,Vestland,2021-02-08,8,49,20021,5580,3.13405476651519,0.873484121530131,57,25601,fhi:git
county,Vestland,2021-02-09,892,305,20913,5885,3.2736869952615804,0.921228325305524,1197,26798,fhi:git
county,Vestland,2021-02-10,2757,970,23670,6855,3.7052632897165205,1.07307054714858,3727,30525,fhi:git
county,Vestland,2021-02-11,2700,834,26370,7689,4.12791689690852,1.20362355025899,3534,34059,fhi:git
county,Vestland,2021-02-12,620,458,26990,8147,4.22497068818965,1.2753181251086,1078,35137,fhi:git
county,Vestland,2021-02-13,0,0,26990,8147,4.22497068818965,1.2753181251086,0,35137,fhi:git
county,Vestland,2021-02-14,0,2,26990,8149,4.22497068818965,1.2756312018546698,2,35139,fhi:git
county,Vestland,2021-02-15,94,1,27084,8150,4.2396852952548505,1.2757877402277,95,35234,fhi:git
county,Vestland,2021-02-16,1087,55,28171,8205,4.40984250674289,1.28439735074458,1142,36376,fhi:git
county,Vestland,2021-02-17,2689,1328,30860,9533,4.8307741918315195,1.4922803101338202,4017,40393,fhi:git
county,Vestland,2021-02-18,2004,1999,32864,11532,5.1444770913918,1.8052005178289399,4003,44396,fhi:git
county,Vestland,2021-02-19,1157,540,34021,12072,5.32559198899222,1.88973123926734,1697,46093,fhi:git
county,Vestland,2021-02-20,3,4,34024,12076,5.32606160411132,1.8903573927594701,7,46100,fhi:git
county,Vestland,2021-02-21,0,1,34024,12077,5.32606160411132,1.89051393113251,1,46101,fhi:git
county,Vestland,2021-02-22,48,2,34072,12079,5.33357544601696,1.89082700787858,50,46151,fhi:git
county,Vestland,2021-02-23,541,591,34613,12670,5.41826270582839,1.98334118634171,1132,47283,fhi:git
county,Vestland,2021-02-24,1340,2400,35953,15070,5.62802412569405,2.35903328162349,3740,51023,fhi:git
county,Vestland,2021-02-25,1234,2645,37187,17715,5.821192478018099,2.77307727829862,3879,54902,fhi:git
county,Vestland,2021-02-26,1395,874,38582,18589,6.039563508400629,2.9098918163304,2269,57171,fhi:git
county,Vestland,2021-02-27,1,0,38583,18589,6.039720046773669,2.9098918163304,1,57172,fhi:git
county,Vestland,2021-02-28,0,7,38583,18596,6.039720046773669,2.91098758494163,7,57179,fhi:git
county,Vestland,2021-03-01,440,11,39023,18607,6.10859693090866,2.9127095070450095,451,57630,fhi:git
county,Vestland,2021-03-02,1340,757,40363,19364,6.318358350774321,3.0312090554318,2097,59727,fhi:git
county,Vestland,2021-03-03,1749,2042,42112,21406,6.5921439652109095,3.3508604131673803,3791,63518,fhi:git
county,Vestland,2021-03-04,1776,2829,43888,24235,6.870156115719429,3.79370747048078,4605,68123,fhi:git
county,Vestland,2021-03-05,1246,894,45134,25129,7.06520292851988,3.9336527759732403,2140,70263,fhi:git
county,Vestland,2021-03-06,1,6,45135,25135,7.06535946689292,3.93459200621144,7,70270,fhi:git
county,Vestland,2021-03-07,2,0,45137,25135,7.06567254363899,3.93459200621144,2,70272,fhi:git
county,Vestland,2021-03-08,630,14,45767,25149,7.164291718650451,3.9367835434339202,644,70916,fhi:git
county,Vestland,2021-03-09,1497,527,47264,25676,7.39862966308246,4.01927926602288,2024,72940,fhi:git
county,Vestland,2021-03-10,2423,1829,49687,27505,7.777922140944019,4.3055879503022005,4252,77192,fhi:git
county,Vestland,2021-03-11,1403,1539,51090,29044,7.997545478310831,4.54650050640164,2942,80134,fhi:git
county,Vestland,2021-03-12,178,929,51268,29973,8.02540930871089,4.691924654950291,1107,81241,fhi:git
county,Vestland,2021-03-13,8,10,51276,29983,8.026661615695161,4.69349003868063,18,81259,fhi:git
county,Vestland,2021-03-14,0,0,51276,29983,8.026661615695161,4.69349003868063,0,81259,fhi:git
county,Vestland,2021-03-15,7,8,51283,29991,8.0277573843064,4.694742345664901,15,81274,fhi:git
county,Vestland,2021-03-16,1189,33,52472,30024,8.21388150984392,4.69990811197503,1222,82496,fhi:git
county,Vestland,2021-03-17,2429,220,54901,30244,8.59411321794368,4.7343465540425305,2649,85145,fhi:git
county,Vestland,2021-03-18,2256,144,57157,30388,8.94726378750855,4.756888079759429,2400,87545,fhi:git
county,Vestland,2021-03-19,579,102,57736,30490,9.037899505495279,4.77285499380891,681,88226,fhi:git
county,Vestland,2021-03-20,1,2,57737,30492,9.03805604386831,4.773168070554981,3,88229,fhi:git
county,Vestland,2021-03-21,0,0,57737,30492,9.03805604386831,4.773168070554981,0,88229,fhi:git
county,Vestland,2021-03-22,7,13,57744,30505,9.03915181247955,4.775203069404419,20,88249,fhi:git
county,Vestland,2021-03-23,1943,324,59687,30829,9.34330587128476,4.825921502267461,2267,90516,fhi:git
county,Viken,2020-12-27,0,0,0,0,0.0,0.0,0,0,fhi:git
county,Viken,2020-12-28,65,0,65,0,0.00523701522360041,0.0,65,65,fhi:git
county,Viken,2020-12-29,689,0,754,0,0.0607493765937647,0.0,689,754,fhi:git
county,Viken,2020-12-30,219,0,973,0,0.0783940894240492,0.0,219,973,fhi:git
county,Viken,2020-12-31,67,0,1040,0,0.0837922435776065,0.0,67,1040,fhi:git
county,Viken,2021-01-01,0,0,1040,0,0.0837922435776065,0.0,0,1040,fhi:git
county,Viken,2021-01-02,0,0,1040,0,0.0837922435776065,0.0,0,1040,fhi:git
county,Viken,2021-01-03,0,0,1040,0,0.0837922435776065,0.0,0,1040,fhi:git
county,Viken,2021-01-04,0,0,1040,0,0.0830416230165828,0.0,0,1040,fhi:git
county,Viken,2021-01-05,526,0,1566,0,0.12504152081150802,0.0,526,1566,fhi:git
county,Viken,2021-01-06,1647,0,3213,0,0.256550706492577,0.0,1647,3213,fhi:git
county,Viken,2021-01-07,1921,0,5134,0,0.409938165929938,0.0,1921,5134,fhi:git
county,Viken,2021-01-08,281,0,5415,0,0.43237537368730394,0.0,281,5415,fhi:git
county,Viken,2021-01-09,6,0,5421,0,0.432854459973938,0.0,6,5421,fhi:git
county,Viken,2021-01-10,5,0,5426,0,0.433253698546133,0.0,5,5426,fhi:git
county,Viken,2021-01-11,57,0,5483,0,0.437805018269157,0.0,57,5483,fhi:git
county,Viken,2021-01-12,788,0,6271,0,0.5007250172471059,0.0,788,6271,fhi:git
county,Viken,2021-01-13,1945,0,8216,0,0.656028821831004,0.0,1945,8216,fhi:git
county,Viken,2021-01-14,1949,0,10165,0,0.8116520172726579,0.0,1949,10165,fhi:git
county,Viken,2021-01-15,1042,0,11207,0,0.894853335718118,0.0,1042,11207,fhi:git
county,Viken,2021-01-16,87,0,11294,0,0.901800086874313,0.0,87,11294,fhi:git
county,Viken,2021-01-17,23,0,11317,0,0.9036365843064108,0.0,23,11317,fhi:git
county,Viken,2021-01-18,143,51,11460,51,0.915054807471191,0.00407223343639012,194,11511,fhi:git
county,Viken,2021-01-19,647,384,12107,435,0.966716278713238,0.0347337557809745,1031,12542,fhi:git
county,Viken,2021-01-20,1490,342,13597,777,1.08568937322738,0.06204167411912001,1832,14374,fhi:git
county,Viken,2021-01-21,1998,100,15595,877,1.24522510667655,0.0700264455630222,2098,16472,fhi:git
county,Viken,2021-01-22,821,1,16416,878,1.31078008023098,0.0701062932774612,822,17294,fhi:git
county,Viken,2021-01-23,98,0,16514,878,1.3186051562460102,0.0701062932774612,98,17392,fhi:git
county,Viken,2021-01-24,0,0,16514,878,1.3186051562460102,0.0701062932774612,0,17392,fhi:git
county,Viken,2021-01-25,62,0,16576,878,1.32355571454123,0.0701062932774612,62,17454,fhi:git
county,Viken,2021-01-26,563,402,17139,1280,1.3685099777704,0.10220507448194802,965,18419,fhi:git
county,Viken,2021-01-27,1941,1216,19080,2496,1.52349439149654,0.199299895239799,3157,21576,fhi:git
county,Viken,2021-01-28,3105,1709,22185,4205,1.7714215448297,0.3357596392160869,4814,26390,fhi:git
county,Viken,2021-01-29,1041,427,23226,4632,1.8545430155607199,0.369854613281549,1468,27858,fhi:git
county,Viken,2021-01-30,9,18,23235,4650,1.8552616449906698,0.37129187214145204,27,27885,fhi:git
county,Viken,2021-01-31,7,3,23242,4653,1.85582057899175,0.371531415284769,10,27895,fhi:git
county,Viken,2021-02-01,36,45,23278,4698,1.85869509671155,0.375124562434525,81,27976,fhi:git
county,Viken,2021-02-02,1023,687,24301,5385,1.9403793085826697,0.429979942254133,1710,29686,fhi:git
county,Viken,2021-02-03,4776,1723,29077,7108,2.32173199274344,0.567557554232568,6499,36185,fhi:git
county,Viken,2021-02-04,6634,1748,35711,8856,2.8514417303319104,0.707131359071978,8382,44567,fhi:git
county,Viken,2021-02-05,3144,1093,38855,9949,3.1024829445282,0.7944049109538291,4237,48804,fhi:git
county,Viken,2021-02-06,37,87,38892,10036,3.10543730996244,0.8013516621100241,124,48928,fhi:git
county,Viken,2021-02-07,15,20,38907,10056,3.10663502567903,0.802948616398804,35,48963,fhi:git
county,Viken,2021-02-08,15,95,38922,10151,3.10783274139561,0.8105341492705109,110,49073,fhi:git
county,Viken,2021-02-09,791,566,39713,10717,3.17099228351688,0.855727955642998,1357,50430,fhi:git
county,Viken,2021-02-10,3438,1324,43151,12041,3.44550872575823,0.961446329560263,4762,55192,fhi:git
county,Viken,2021-02-11,4843,1916,47994,13957,3.8322112067864196,1.11443455042543,6759,61951,fhi:git
county,Viken,2021-02-12,2428,977,50422,14934,4.026081457444359,1.19244576743235,3405,65356,fhi:git
county,Viken,2021-02-13,23,97,50445,15031,4.02791795487646,1.20019099573294,120,65476,fhi:git
county,Viken,2021-02-14,6,0,50451,15031,4.02839704116309,1.20019099573294,6,65482,fhi:git
county,Viken,2021-02-15,354,125,50805,15156,4.05666313207451,1.21017196003782,479,65961,fhi:git
county,Viken,2021-02-16,1424,359,52229,15515,4.17036627743568,1.23883728952142,1783,67744,fhi:git
county,Viken,2021-02-17,4416,1811,56645,17326,4.5229737843984,1.3834415003704899,6227,73971,fhi:git
county,Viken,2021-02-18,4884,2924,61529,20250,4.91295002171858,1.61691621739019,7808,81779,fhi:git
county,Viken,2021-02-19,3795,1282,65324,21532,5.21597209801467,1.71928098730102,5077,86856,fhi:git
county,Viken,2021-02-20,28,8,65352,21540,5.21820783401896,1.71991976901653,36,86892,fhi:git
county,Viken,2021-02-21,1,6,65353,21546,5.2182876817334005,1.7203988553031697,7,86899,fhi:git
county,Viken,2021-02-22,698,8,66051,21554,5.27402138641184,1.72103763701868,706,87605,fhi:git
county,Viken,2021-02-23,2129,755,68180,22309,5.44401717045251,1.78132266142014,2884,90489,fhi:git
county,Viken,2021-02-24,2462,4193,70642,26502,5.640602243401389,2.11612412806296,6655,97144,fhi:git
county,Viken,2021-02-25,2544,6250,73186,32752,5.843734828934259,2.6151723433068503,8794,105938,fhi:git
county,Viken,2021-02-26,1930,2718,75116,35470,5.997840917801571,2.83219843115211,4648,110586,fhi:git
county,Viken,2021-02-27,166,88,75282,35558,6.011095638398451,2.83922503002274,254,110840,fhi:git
county,Viken,2021-02-28,416,1,75698,35559,6.044312287605081,2.83930487773718,417,111257,fhi:git
county,Viken,2021-03-01,1519,2,77217,35561,6.1656009658379505,2.83946457316606,1521,112778,fhi:git
county,Viken,2021-03-02,3008,518,80225,36079,6.4057828908705305,2.8808256892454702,3526,116304,fhi:git
county,Viken,2021-03-03,4946,2695,85171,38774,6.80070968648593,3.09601527965864,7641,123945,fhi:git
county,Viken,2021-03-04,4376,3258,89547,42032,7.150123284871089,3.35615913330097,7634,131579,fhi:git
county,Viken,2021-03-05,2732,1779,92279,43811,7.3682672407185,3.4982082172879903,4511,136090,fhi:git
county,Viken,2021-03-06,159,0,92438,43811,7.38096302731431,3.4982082172879903,159,136249,fhi:git
county,Viken,2021-03-07,17,0,92455,43811,7.38232043845977,3.4982082172879903,17,136266,fhi:git
county,Viken,2021-03-08,1130,22,93585,43833,7.472548355775861,3.49996486700565,1152,137418,fhi:git
county,Viken,2021-03-09,2887,713,96472,44546,7.703068707361321,3.55689628740067,3600,141018,fhi:git
county,Viken,2021-03-10,5360,3165,101832,47711,8.13105245675448,3.80961430360017,8525,149543,fhi:git
county,Viken,2021-03-11,3397,4749,105229,52460,8.40229514270384,4.188811099471089,8146,157689,fhi:git
county,Viken,2021-03-12,1207,3273,106436,55733,8.49867133403174,4.450152668830009,4480,162169,fhi:git
county,Viken,2021-03-13,6,8,106442,55741,8.49915042031837,4.45079145054552,14,162183,fhi:git
county,Viken,2021-03-14,2,5,106444,55746,8.49931011574725,4.45119068911772,7,162190,fhi:git
county,Viken,2021-03-15,35,44,106479,55790,8.50210478575261,4.454703988553031,79,162269,fhi:git
county,Viken,2021-03-16,774,302,107253,56092,8.56390691672842,4.4788179983136205,1076,163345,fhi:git
county,Viken,2021-03-17,3962,401,111215,56493,8.88026356133582,4.51083693180366,4363,167708,fhi:git
county,Viken,2021-03-18,5704,411,116919,56904,9.335714924496,4.543654342438099,6115,173823,fhi:git
county,Viken,2021-03-19,1830,356,118749,57260,9.48183624191941,4.572080128778389,2186,176009,fhi:git
county,Viken,2021-03-20,5,1,118754,57261,9.48223548049161,4.57215997649283,6,176015,fhi:git
county,Viken,2021-03-21,6,1,118760,57262,9.48271456677824,4.572239824207269,7,176022,fhi:git
county,Viken,2021-03-22,398,18,119158,57280,9.514493957124971,4.57367708306717,416,176438,fhi:git
county,Viken,2021-03-23,2234,69,121392,57349,9.69287375118175,4.57918657536347,2303,178741,fhi:git
nation,Norge,2020-12-27,5,0,5,0,9.31518486915891e-05,0.0,5,5,fhi:git
nation,Norge,2020-12-28,603,0,608,0,0.0113272648008972,0.0,603,608,fhi:git
nation,Norge,2020-12-29,1067,0,1675,0,0.0312058693116824,0.0,1067,1675,fhi:git
nation,Norge,2020-12-30,427,0,2102,0,0.0391610371899441,0.0,427,2102,fhi:git
nation,Norge,2020-12-31,72,0,2174,0,0.040502423811103,0.0,72,2174,fhi:git
nation,Norge,2021-01-01,6,0,2180,0,0.0406142060295329,0.0,6,2180,fhi:git
nation,Norge,2021-01-02,0,0,2180,0,0.0406142060295329,0.0,0,2180,fhi:git
nation,Norge,2021-01-03,3,0,2183,0,0.0406700971387478,0.0,3,2183,fhi:git
nation,Norge,2021-01-04,6,0,2189,0,0.0406019324590841,0.0,6,2189,fhi:git
nation,Norge,2021-01-05,3385,0,5574,0,0.103387469861551,0.0,3385,5574,fhi:git
nation,Norge,2021-01-06,9064,0,14638,0,0.271508034415749,0.0,9064,14638,fhi:git
nation,Norge,2021-01-07,6553,0,21191,0,0.39305415748764394,0.0,6553,21191,fhi:git
nation,Norge,2021-01-08,1615,0,22806,0,0.42300944342707797,0.0,1615,22806,fhi:git
nation,Norge,2021-01-09,135,0,22941,0,0.425513445657309,0.0,135,22941,fhi:git
nation,Norge,2021-01-10,108,0,23049,0,0.4275166474414939,0.0,108,23049,fhi:git
nation,Norge,2021-01-11,353,0,23402,0,0.434064149569432,0.0,353,23402,fhi:git
nation,Norge,2021-01-12,4258,0,27660,0,0.5130422347273951,0.0,4258,27660,fhi:git
nation,Norge,2021-01-13,9775,0,37435,0,0.694350544360811,0.0,9775,37435,fhi:git
nation,Norge,2021-01-14,8470,0,45905,0,0.8514534991019909,0.0,8470,45905,fhi:git
nation,Norge,2021-01-15,4470,0,50375,0,0.9343637951696501,0.0,4470,50375,fhi:git
nation,Norge,2021-01-16,745,0,51120,0,0.948182177847593,0.0,745,51120,fhi:git
nation,Norge,2021-01-17,349,5,51469,5,0.9546554873168579,9.27408233419007e-05,354,51474,fhi:git
nation,Norge,2021-01-18,1284,283,52753,288,0.978471330751058,0.00534187142449348,1567,53041,fhi:git
nation,Norge,2021-01-19,4587,772,57340,1060,1.0635517620849202,0.019661054548483003,5359,58400,fhi:git
nation,Norge,2021-01-20,10061,693,67401,1753,1.25016484681349,0.0325149326636704,10754,69154,fhi:git
nation,Norge,2021-01-21,8429,169,75830,1922,1.40650732680327,0.0356495724926266,8598,77752,fhi:git
nation,Norge,2021-01-22,3317,7,79147,1929,1.46803158900828,0.0357794096453053,3324,81076,fhi:git
nation,Norge,2021-01-23,359,0,79506,1929,1.4746903801242301,0.0357794096453053,359,81435,fhi:git
nation,Norge,2021-01-24,67,0,79573,1929,1.47593310715701,0.0357794096453053,67,81502,fhi:git
nation,Norge,2021-01-25,581,0,80154,1929,1.4867095908293402,0.0357794096453053,581,82083,fhi:git
nation,Norge,2021-01-26,2278,2142,82432,4071,1.52896230994391,0.0755095783649756,4420,86503,fhi:git
nation,Norge,2021-01-27,11409,7593,93841,11664,1.74057832064546,0.21634579269198603,19002,105505,fhi:git
nation,Norge,2021-01-28,10900,6572,104741,18236,1.9427533155307999,0.33824433089258,17472,122977,fhi:git
nation,Norge,2021-01-29,3807,2106,108548,20342,2.0133661784233303,0.37730676568418897,5913,128890,fhi:git
nation,Norge,2021-01-30,146,172,108694,20514,2.01607421046491,0.38049705000715,318,129208,fhi:git
nation,Norge,2021-01-31,97,51,108791,20565,2.01787338243774,0.381443006405238,148,129356,fhi:git
nation,Norge,2021-02-01,198,301,108989,20866,2.02154591904208,0.38702600397042,499,129855,fhi:git
nation,Norge,2021-02-02,6357,3143,115346,24009,2.13945660183898,0.4453228855231389,9500,139355,fhi:git
nation,Norge,2021-02-03,25133,8314,140479,32323,2.60562762444937,0.599532326576052,33447,172802,fhi:git
nation,Norge,2021-02-04,25959,8647,166438,40970,3.08711943107586,0.759918306463535,34606,207408,fhi:git
nation,Norge,2021-02-05,10626,4859,177064,45829,3.28421222884206,0.8500438385871941,15485,222893,fhi:git
nation,Norge,2021-02-06,808,735,177872,46564,3.2991991458941095,0.8636767396184529,1543,224436,fhi:git
nation,Norge,2021-02-07,320,296,178192,46860,3.305134558588,0.869166996360294,616,225052,fhi:git
nation,Norge,2021-02-08,120,922,178312,47782,3.3073603383482,0.8862684041845401,1042,226094,fhi:git
nation,Norge,2021-02-09,5541,3239,183853,51021,3.4101357187757,0.946345909545423,8780,234874,fhi:git
nation,Norge,2021-02-10,22984,8664,206837,59685,3.83644673551374,1.10704720823227,31648,266522,fhi:git
nation,Norge,2021-02-11,20936,8567,227773,68252,4.22477111101095,1.26594933494628,29503,296025,fhi:git
nation,Norge,2021-02-12,8041,3610,235814,71862,4.3739169031094,1.3329082093991298,11651,307676,fhi:git
nation,Norge,2021-02-13,892,306,236706,72168,4.39046186599359,1.33858394778766,1198,308874,fhi:git
nation,Norge,2021-02-14,110,2,236816,72170,4.39250216410711,1.338621044117,112,308986,fhi:git
nation,Norge,2021-02-15,803,751,237619,72921,4.40739634033582,1.35255071578295,1554,310540,fhi:git
nation,Norge,2021-02-16,6026,2175,243645,75096,4.519167580627481,1.39289297393668,8201,318741,fhi:git
nation,Norge,2021-02-17,21796,10196,265441,85292,4.92344337773949,1.58201006089548,31992,350733,fhi:git
nation,Norge,2021-02-18,18864,10813,284305,96105,5.27333595604382,1.78257136545467,29677,380410,fhi:git
nation,Norge,2021-02-19,10736,4798,295041,100903,5.47246905192355,1.87156545953356,15534,395944,fhi:git
nation,Norge,2021-02-20,498,171,295539,101074,5.4817060379284,1.87473719569186,669,396613,fhi:git
nation,Norge,2021-02-21,58,97,295597,101171,5.48278183147917,1.87653636766469,155,396768,fhi:git
nation,Norge,2021-02-22,2568,141,298165,101312,5.530413518347571,1.87915165888293,2709,399477,fhi:git
nation,Norge,2021-02-23,5745,5204,303910,106516,5.63697272436741,1.97567630781718,10949,410426,fhi:git
nation,Norge,2021-02-24,10955,22329,314865,128845,5.8401678683095195,2.3898382766974398,33284,443710,fhi:git
nation,Norge,2021-02-25,11117,25031,325982,153876,6.046367814927899,2.85411738651166,36148,479858,fhi:git
nation,Norge,2021-02-26,8295,9923,334277,163799,6.20022484085211,3.038170824516,18218,498076,fhi:git
nation,Norge,2021-02-27,440,201,334717,164000,6.2083860333062,3.0418990056143396,641,498717,fhi:git
nation,Norge,2021-02-28,538,159,335255,164159,6.2183649458977905,3.0448481637966203,697,499414,fhi:git
nation,Norge,2021-03-01,5914,62,341169,164221,6.3280587917465905,3.04599815000606,5976,505390,fhi:git
nation,Norge,2021-03-02,10501,3820,351670,168041,6.52283306892925,3.1168521390392705,14321,519711,fhi:git
nation,Norge,2021-03-03,17605,18007,369275,186048,6.84937350791608,3.4508489402227904,35612,555323,fhi:git
nation,Norge,2021-03-04,16174,18421,385449,204469,7.14937152326246,3.79252468157902,34595,589918,fhi:git
nation,Norge,2021-03-05,11883,6508,397332,210977,7.3697793640168205,3.9132361372408395,18391,608309,fhi:git
nation,Norge,2021-03-06,316,477,397648,211454,7.37564058405203,3.9220836117876603,793,609102,fhi:git
nation,Norge,2021-03-07,90,1,397738,211455,7.37730991887218,3.92210215995232,91,609193,fhi:git
nation,Norge,2021-03-08,4888,46,402626,211501,7.4679733477712205,3.9229553755270694,4934,614127,fhi:git
nation,Norge,2021-03-09,12274,4270,414900,215771,7.69563352091092,4.00215603866105,16544,630671,fhi:git
nation,Norge,2021-03-10,20875,17146,435775,232917,8.08282645836336,4.3201828700651,38021,668692,fhi:git
nation,Norge,2021-03-11,11916,16509,447691,249426,8.30384638855178,4.62639452057539,28425,697117,fhi:git
nation,Norge,2021-03-12,2300,8220,449991,257646,8.34650716728905,4.77886043414947,10520,707637,fhi:git
nation,Norge,2021-03-13,35,303,450026,257949,8.34715635305244,4.78448052804399,338,707975,fhi:git
nation,Norge,2021-03-14,3,103,450029,258052,8.34721199754645,4.78639098900483,106,708081,fhi:git
nation,Norge,2021-03-15,99,432,450128,258484,8.34904826584862,4.79440379614157,531,708612,fhi:git
nation,Norge,2021-03-16,5636,625,455764,259109,8.45358572191961,4.8059963990593095,6261,714873,fhi:git
nation,Norge,2021-03-17,22976,1534,478740,260643,8.879748353340311,4.83444928366061,24510,739383,fhi:git
nation,Norge,2021-03-18,20711,1361,499451,262004,9.263899391787131,4.85969333577427,22072,761455,fhi:git
nation,Norge,2021-03-19,6525,942,505976,262946,9.384926166248311,4.87716570689189,7467,768922,fhi:git
nation,Norge,2021-03-20,453,20,506429,262966,9.39332848484309,4.87753667018525,473,769395,fhi:git
nation,Norge,2021-03-21,187,68,506616,263034,9.39679699163608,4.8787979453827,255,769650,fhi:git
nation,Norge,2021-03-22,1503,70,508119,263104,9.424674883132651,4.880096316909491,1573,771223,fhi:git
nation,Norge,2021-03-23,11948,680,520067,263784,9.646288354590462,4.89270906888399,12628,783851,fhi:git
